Number of OTUs	Number of Clustered Sequences	Number of Replicates	Total Number of Sequences	Sample Name	Path
1	2	0	3	OSD188_6_14_RI	Archaea;Euryarchaeota;Halobacteria;Halobacteriales;Halobacteriaceae;uncultured;
123	471	578	1172	OSD188_6_14_RI	Archaea;Euryarchaeota;Thermoplasmata;Thermoplasmatales;Marine Group II;
16	56	93	165	OSD188_6_14_RI	Archaea;Euryarchaeota;Thermoplasmata;Thermoplasmatales;Marine Group III;
1	0	0	1	OSD188_6_14_RI	Archaea;Thaumarchaeota;Marine Group I;
3	58	112	173	OSD188_6_14_RI	Archaea;Thaumarchaeota;Marine Group I;Unknown Order;Unknown Family;Candidatus Nitrosopelagicus;
4	20	31	55	OSD188_6_14_RI	Archaea;Thaumarchaeota;Marine Group I;Unknown Order;Unknown Family;Candidatus Nitrosopumilus;
1	0	0	1	OSD188_6_14_RI	Archaea;Woesearchaeota (DHVEG-6);
1	0	0	1	OSD188_6_14_RI	Bacteria;Acidobacteria;Subgroup 17;
3	1	0	4	OSD188_6_14_RI	Bacteria;Acidobacteria;Subgroup 22;
1	0	0	1	OSD188_6_14_RI	Bacteria;Acidobacteria;Subgroup 26;
3	0	0	3	OSD188_6_14_RI	Bacteria;Actinobacteria;Acidimicrobiia;Acidimicrobiales;Acidimicrobiaceae;Ilumatobacter;
3	0	0	3	OSD188_6_14_RI	Bacteria;Actinobacteria;Acidimicrobiia;Acidimicrobiales;Acidimicrobiaceae;uncultured;
2	1	0	3	OSD188_6_14_RI	Bacteria;Actinobacteria;Acidimicrobiia;Acidimicrobiales;OM1 clade;
165	530	813	1508	OSD188_6_14_RI	Bacteria;Actinobacteria;Acidimicrobiia;Acidimicrobiales;OM1 clade;Candidatus Actinomarina;
94	151	186	431	OSD188_6_14_RI	Bacteria;Actinobacteria;Acidimicrobiia;Acidimicrobiales;Sva0996 marine group;
1	0	0	1	OSD188_6_14_RI	Bacteria;Actinobacteria;Acidimicrobiia;Acidimicrobiales;uncultured;
1	0	0	1	OSD188_6_14_RI	Bacteria;Actinobacteria;Actinobacteria;Corynebacteriales;Dietziaceae;Dietzia;
1	0	0	1	OSD188_6_14_RI	Bacteria;Actinobacteria;Actinobacteria;Micrococcales;Cellulomonadaceae;Actinotalea;
1	0	0	1	OSD188_6_14_RI	Bacteria;Actinobacteria;Actinobacteria;Micrococcales;Intrasporangiaceae;Serinicoccus;
1	0	0	1	OSD188_6_14_RI	Bacteria;Actinobacteria;Actinobacteria;Micrococcales;Micrococcaceae;Kocuria;
2	3	3	8	OSD188_6_14_RI	Bacteria;Actinobacteria;Actinobacteria;PeM15;
5	0	0	5	OSD188_6_14_RI	Bacteria;Bacteroidetes;Bacteroidetes Incertae Sedis;Order II;Rhodothermaceae;uncultured;
2	4	2	8	OSD188_6_14_RI	Bacteria;Bacteroidetes;Bacteroidetes Incertae Sedis;Order III;Unknown Family;Balneola;
1	0	0	1	OSD188_6_14_RI	Bacteria;Bacteroidetes;Bacteroidia;Bacteroidales;Marinilabiaceae;uncultured;
1	1	0	2	OSD188_6_14_RI	Bacteria;Bacteroidetes;Bacteroidia;Bacteroidales;Prolixibacteraceae;Prolixibacter;
1	0	0	1	OSD188_6_14_RI	Bacteria;Bacteroidetes;Bacteroidia;Bacteroidales;Rikenellaceae;Rikenella;
1	0	0	1	OSD188_6_14_RI	Bacteria;Bacteroidetes;Cytophagia;Cytophagales;Flammeovirgaceae;Aureibacter;
1	1	0	2	OSD188_6_14_RI	Bacteria;Bacteroidetes;Cytophagia;Cytophagales;Flammeovirgaceae;Fabibacter;
30	55	89	174	OSD188_6_14_RI	Bacteria;Bacteroidetes;Cytophagia;Cytophagales;Flammeovirgaceae;Marinoscillum;
13	5	4	22	OSD188_6_14_RI	Bacteria;Bacteroidetes;Cytophagia;Cytophagales;Flammeovirgaceae;uncultured;
7	2	1	10	OSD188_6_14_RI	Bacteria;Bacteroidetes;Flavobacteriia;Flavobacteriales;Cryomorphaceae;Crocinitomix;
1	0	0	1	OSD188_6_14_RI	Bacteria;Bacteroidetes;Flavobacteriia;Flavobacteriales;Cryomorphaceae;Cryomorpha;
11	16	9	36	OSD188_6_14_RI	Bacteria;Bacteroidetes;Flavobacteriia;Flavobacteriales;Cryomorphaceae;Fluviicola;
5	5	12	22	OSD188_6_14_RI	Bacteria;Bacteroidetes;Flavobacteriia;Flavobacteriales;Cryomorphaceae;NS10 marine group;
3	0	0	3	OSD188_6_14_RI	Bacteria;Bacteroidetes;Flavobacteriia;Flavobacteriales;Cryomorphaceae;Salinirepens;
47	47	48	142	OSD188_6_14_RI	Bacteria;Bacteroidetes;Flavobacteriia;Flavobacteriales;Cryomorphaceae;uncultured;
4	0	1	5	OSD188_6_14_RI	Bacteria;Bacteroidetes;Flavobacteriia;Flavobacteriales;Flavobacteriaceae;Actibacter;
1	0	0	1	OSD188_6_14_RI	Bacteria;Bacteroidetes;Flavobacteriia;Flavobacteriales;Flavobacteriaceae;Algitalea;
2	3	2	7	OSD188_6_14_RI	Bacteria;Bacteroidetes;Flavobacteriia;Flavobacteriales;Flavobacteriaceae;Aquibacter;
1	3	1	5	OSD188_6_14_RI	Bacteria;Bacteroidetes;Flavobacteriia;Flavobacteriales;Flavobacteriaceae;Aureisphaera;
1	1	4	6	OSD188_6_14_RI	Bacteria;Bacteroidetes;Flavobacteriia;Flavobacteriales;Flavobacteriaceae;Aureitalea;
1	0	0	1	OSD188_6_14_RI	Bacteria;Bacteroidetes;Flavobacteriia;Flavobacteriales;Flavobacteriaceae;Empedobacter;
2	0	0	2	OSD188_6_14_RI	Bacteria;Bacteroidetes;Flavobacteriia;Flavobacteriales;Flavobacteriaceae;Flavicella;
1	0	0	1	OSD188_6_14_RI	Bacteria;Bacteroidetes;Flavobacteriia;Flavobacteriales;Flavobacteriaceae;Formosa;
36	128	219	383	OSD188_6_14_RI	Bacteria;Bacteroidetes;Flavobacteriia;Flavobacteriales;Flavobacteriaceae;NS2b marine group;
72	175	141	388	OSD188_6_14_RI	Bacteria;Bacteroidetes;Flavobacteriia;Flavobacteriales;Flavobacteriaceae;NS4 marine group;
112	353	504	969	OSD188_6_14_RI	Bacteria;Bacteroidetes;Flavobacteriia;Flavobacteriales;Flavobacteriaceae;NS5 marine group;
1	0	0	1	OSD188_6_14_RI	Bacteria;Bacteroidetes;Flavobacteriia;Flavobacteriales;Flavobacteriaceae;Pibocella;
1	3	1	5	OSD188_6_14_RI	Bacteria;Bacteroidetes;Flavobacteriia;Flavobacteriales;Flavobacteriaceae;Polaribacter 2;
1	0	0	1	OSD188_6_14_RI	Bacteria;Bacteroidetes;Flavobacteriia;Flavobacteriales;Flavobacteriaceae;Polaribacter 4;
1	0	0	1	OSD188_6_14_RI	Bacteria;Bacteroidetes;Flavobacteriia;Flavobacteriales;Flavobacteriaceae;Postechiella;
1	0	1	2	OSD188_6_14_RI	Bacteria;Bacteroidetes;Flavobacteriia;Flavobacteriales;Flavobacteriaceae;Psychroflexus;
12	22	5	39	OSD188_6_14_RI	Bacteria;Bacteroidetes;Flavobacteriia;Flavobacteriales;Flavobacteriaceae;Tenacibaculum;
1	1	0	2	OSD188_6_14_RI	Bacteria;Bacteroidetes;Flavobacteriia;Flavobacteriales;Flavobacteriaceae;Ulvibacter;
8	7	7	22	OSD188_6_14_RI	Bacteria;Bacteroidetes;Flavobacteriia;Flavobacteriales;Flavobacteriaceae;uncultured;
1	0	0	1	OSD188_6_14_RI	Bacteria;Bacteroidetes;Flavobacteriia;Flavobacteriales;Flavobacteriaceae;Wenyingzhuangia;
3	1	0	4	OSD188_6_14_RI	Bacteria;Bacteroidetes;Flavobacteriia;Flavobacteriales;Flavobacteriaceae;Winogradskyella;
20	21	21	62	OSD188_6_14_RI	Bacteria;Bacteroidetes;Flavobacteriia;Flavobacteriales;NS7 marine group;
144	294	306	744	OSD188_6_14_RI	Bacteria;Bacteroidetes;Flavobacteriia;Flavobacteriales;NS9 marine group;
1	0	0	1	OSD188_6_14_RI	Bacteria;Bacteroidetes;Flavobacteriia;Flavobacteriales;Schleiferiaceae;Schleiferia;
1	0	0	1	OSD188_6_14_RI	Bacteria;Bacteroidetes;Sphingobacteriia;Sphingobacteriales;Chitinophagaceae;Taibaiella;
1	0	0	1	OSD188_6_14_RI	Bacteria;Bacteroidetes;Sphingobacteriia;Sphingobacteriales;Lentimicrobiaceae;
3	0	0	3	OSD188_6_14_RI	Bacteria;Bacteroidetes;Sphingobacteriia;Sphingobacteriales;Saprospiraceae;Aureispira;
6	0	0	6	OSD188_6_14_RI	Bacteria;Bacteroidetes;Sphingobacteriia;Sphingobacteriales;Saprospiraceae;Lewinella;
1	0	0	1	OSD188_6_14_RI	Bacteria;Bacteroidetes;Sphingobacteriia;Sphingobacteriales;Saprospiraceae;Rubidimonas;
3	1	0	4	OSD188_6_14_RI	Bacteria;Bacteroidetes;Sphingobacteriia;Sphingobacteriales;Saprospiraceae;Saprospira;
19	20	8	47	OSD188_6_14_RI	Bacteria;Bacteroidetes;Sphingobacteriia;Sphingobacteriales;Saprospiraceae;uncultured;
2	0	0	2	OSD188_6_14_RI	Bacteria;Bacteroidetes;Sphingobacteriia;Sphingobacteriales;uncultured;
1	0	0	1	OSD188_6_14_RI	Bacteria;Chlamydiae;Chlamydiae;Chlamydiales;Chlamydiaceae;uncultured;
2	1	0	3	OSD188_6_14_RI	Bacteria;Chlamydiae;Chlamydiae;Chlamydiales;Parachlamydiaceae;Neochlamydia;
1	0	0	1	OSD188_6_14_RI	Bacteria;Chlamydiae;Chlamydiae;Chlamydiales;Simkaniaceae;
2	1	0	3	OSD188_6_14_RI	Bacteria;Chlamydiae;Chlamydiae;Chlamydiales;Simkaniaceae;uncultured;
1	0	1	2	OSD188_6_14_RI	Bacteria;Chloroflexi;Anaerolineae;Anaerolineales;Anaerolineaceae;uncultured;
1	0	0	1	OSD188_6_14_RI	Bacteria;Chloroflexi;Ardenticatenia;uncultured;
6	3	3	12	OSD188_6_14_RI	Bacteria;Chloroflexi;JG30-KF-CM66;
52	62	65	179	OSD188_6_14_RI	Bacteria;Chloroflexi;SAR202 clade;
344	636	640	1620	OSD188_6_14_RI	Bacteria;Cyanobacteria;Chloroplast;
1	0	0	1	OSD188_6_14_RI	Bacteria;Cyanobacteria;Cyanobacteria;SubsectionI;FamilyI;
125	208	193	526	OSD188_6_14_RI	Bacteria;Cyanobacteria;Cyanobacteria;SubsectionI;FamilyI;Prochlorococcus;
151	484	1019	1654	OSD188_6_14_RI	Bacteria;Cyanobacteria;Cyanobacteria;SubsectionI;FamilyI;Synechococcus;
1	0	0	1	OSD188_6_14_RI	Bacteria;Cyanobacteria;Cyanobacteria;SubsectionIII;FamilyI;Leptolyngbya;
1	0	0	1	OSD188_6_14_RI	Bacteria;Cyanobacteria;Cyanobacteria;SubsectionIII;FamilyI;Oscillatoria;
1	0	0	1	OSD188_6_14_RI	Bacteria;Cyanobacteria;Cyanobacteria;SubsectionIII;FamilyI;Trichodesmium;
1	0	0	1	OSD188_6_14_RI	Bacteria;Cyanobacteria;Cyanobacteria;SubsectionIV;FamilyII;Calothrix;
1	0	0	1	OSD188_6_14_RI	Bacteria;Cyanobacteria;Melainabacteria;Obscuribacterales;
10	0	2	12	OSD188_6_14_RI	Bacteria;Cyanobacteria;ML635J-21;
1	0	0	1	OSD188_6_14_RI	Bacteria;Deinococcus-Thermus;Deinococci;Deinococcales;Trueperaceae;Truepera;
2	0	0	2	OSD188_6_14_RI	Bacteria;Firmicutes;Bacilli;Bacillales;Bacillaceae;Bacillus;
1	0	0	1	OSD188_6_14_RI	Bacteria;Firmicutes;Bacilli;Bacillales;Staphylococcaceae;Staphylococcus;
1	0	0	1	OSD188_6_14_RI	Bacteria;Firmicutes;Bacilli;Lactobacillales;Carnobacteriaceae;Carnobacterium;
1	0	1	2	OSD188_6_14_RI	Bacteria;Firmicutes;Bacilli;Lactobacillales;Streptococcaceae;Streptococcus;
1	0	0	1	OSD188_6_14_RI	Bacteria;Firmicutes;Clostridia;Clostridiales;Clostridiales vadinBB60 group;
1	0	0	1	OSD188_6_14_RI	Bacteria;Firmicutes;Clostridia;Clostridiales;Peptostreptococcaceae;Intestinibacter;
1	0	0	1	OSD188_6_14_RI	Bacteria;Firmicutes;Clostridia;Halanaerobiales;ODP1230B8.23;
1	0	0	1	OSD188_6_14_RI	Bacteria;Firmicutes;Erysipelotrichia;Erysipelotrichales;Erysipelotrichaceae;Erysipelatoclostridium;
1	0	0	1	OSD188_6_14_RI	Bacteria;Firmicutes;Negativicutes;Selenomonadales;Veillonellaceae;Veillonella;
1	1	0	2	OSD188_6_14_RI	Bacteria;Fusobacteria;Fusobacteriia;Fusobacteriales;Fusobacteriaceae;Propionigenium;
11	16	7	34	OSD188_6_14_RI	Bacteria;Gemmatimonadetes;BD2-11 terrestrial group;
1	0	0	1	OSD188_6_14_RI	Bacteria;Gemmatimonadetes;PAUC43f marine benthic group;
2	0	0	2	OSD188_6_14_RI	Bacteria;Latescibacteria;
3	2	0	5	OSD188_6_14_RI	Bacteria;Lentisphaerae;Lentisphaeria;Lentisphaerales;Lentisphaeraceae;Lentisphaera;
299	636	613	1548	OSD188_6_14_RI	Bacteria;Marinimicrobia (SAR406 clade);
2	0	0	2	OSD188_6_14_RI	Bacteria;Nitrospinae;MD2898-B26;
2	0	0	2	OSD188_6_14_RI	Bacteria;Nitrospirae;Nitrospira;Nitrospirales;Nitrospiraceae;Leptospirillum;
1	0	0	1	OSD188_6_14_RI	Bacteria;Nitrospirae;Nitrospira;Nitrospirales;Nitrospiraceae;Nitrospira;
1	0	0	1	OSD188_6_14_RI	Bacteria;Omnitrophica;
1	0	0	1	OSD188_6_14_RI	Bacteria;Omnitrophica;Omnitrophica Incertae Sedis;Unknown Order;Unknown Family;Candidatus Omnitrophus;
7	4	0	11	OSD188_6_14_RI	Bacteria;PAUC34f;
3	0	0	3	OSD188_6_14_RI	Bacteria;Planctomycetes;BD7-11;
16	8	9	33	OSD188_6_14_RI	Bacteria;Planctomycetes;OM190;
25	33	15	73	OSD188_6_14_RI	Bacteria;Planctomycetes;Phycisphaerae;Phycisphaerales;Phycisphaeraceae;CL500-3;
12	13	5	30	OSD188_6_14_RI	Bacteria;Planctomycetes;Phycisphaerae;Phycisphaerales;Phycisphaeraceae;FS140-16B-02 marine group;
2	1	3	6	OSD188_6_14_RI	Bacteria;Planctomycetes;Phycisphaerae;Phycisphaerales;Phycisphaeraceae;JL-ETNP-F27;
1	0	0	1	OSD188_6_14_RI	Bacteria;Planctomycetes;Phycisphaerae;Phycisphaerales;Phycisphaeraceae;SM1A02;
14	32	34	80	OSD188_6_14_RI	Bacteria;Planctomycetes;Phycisphaerae;Phycisphaerales;Phycisphaeraceae;Urania-1B-19 marine sediment group;
1	0	0	1	OSD188_6_14_RI	Bacteria;Planctomycetes;Pla3 lineage;
2	0	0	2	OSD188_6_14_RI	Bacteria;Planctomycetes;Pla4 lineage;
4	0	0	4	OSD188_6_14_RI	Bacteria;Planctomycetes;Planctomycetacia;Planctomycetales;Planctomycetaceae;Blastopirellula;
1	0	0	1	OSD188_6_14_RI	Bacteria;Planctomycetes;Planctomycetacia;Planctomycetales;Planctomycetaceae;Pirellula;
6	6	14	26	OSD188_6_14_RI	Bacteria;Planctomycetes;Planctomycetacia;Planctomycetales;Planctomycetaceae;Planctomyces;
7	2	0	9	OSD188_6_14_RI	Bacteria;Planctomycetes;Planctomycetacia;Planctomycetales;Planctomycetaceae;Rhodopirellula;
2	2	1	5	OSD188_6_14_RI	Bacteria;Planctomycetes;Planctomycetacia;Planctomycetales;Planctomycetaceae;Rubripirellula;
5	0	1	6	OSD188_6_14_RI	Bacteria;Planctomycetes;Planctomycetacia;Planctomycetales;Planctomycetaceae;uncultured;
1	2	2	5	OSD188_6_14_RI	Bacteria;Poribacteria;
2	4	1	7	OSD188_6_14_RI	Bacteria;Proteobacteria;AEGEAN-245;
1	3	1	5	OSD188_6_14_RI	Bacteria;Proteobacteria;Alphaproteobacteria;Alphaproteobacteria Incertae Sedis;Unknown Family;uncultured;
2	0	0	2	OSD188_6_14_RI	Bacteria;Proteobacteria;Alphaproteobacteria;Caulobacterales;Caulobacteraceae;Brevundimonas;
2	0	0	2	OSD188_6_14_RI	Bacteria;Proteobacteria;Alphaproteobacteria;Caulobacterales;Hyphomonadaceae;
1	0	0	1	OSD188_6_14_RI	Bacteria;Proteobacteria;Alphaproteobacteria;Caulobacterales;Hyphomonadaceae;Henriciella;
2	1	0	3	OSD188_6_14_RI	Bacteria;Proteobacteria;Alphaproteobacteria;Caulobacterales;Hyphomonadaceae;Litorimonas;
1	0	0	1	OSD188_6_14_RI	Bacteria;Proteobacteria;Alphaproteobacteria;Caulobacterales;Hyphomonadaceae;Maricaulis;
4	0	0	4	OSD188_6_14_RI	Bacteria;Proteobacteria;Alphaproteobacteria;Caulobacterales;Hyphomonadaceae;uncultured;
1	0	0	1	OSD188_6_14_RI	Bacteria;Proteobacteria;Alphaproteobacteria;Rhizobiales;Aurantimonadaceae;Aureimonas;
7	11	3	21	OSD188_6_14_RI	Bacteria;Proteobacteria;Alphaproteobacteria;Rhizobiales;Bradyrhizobiaceae;Bradyrhizobium;
6	18	8	32	OSD188_6_14_RI	Bacteria;Proteobacteria;Alphaproteobacteria;Rhizobiales;OCS116 clade;
1	0	0	1	OSD188_6_14_RI	Bacteria;Proteobacteria;Alphaproteobacteria;Rhizobiales;Phyllobacteriaceae;Phyllobacterium;
3	2	0	5	OSD188_6_14_RI	Bacteria;Proteobacteria;Alphaproteobacteria;Rhizobiales;Phyllobacteriaceae;uncultured;
64	129	142	335	OSD188_6_14_RI	Bacteria;Proteobacteria;Alphaproteobacteria;Rhizobiales;PS1 clade;
1	0	0	1	OSD188_6_14_RI	Bacteria;Proteobacteria;Alphaproteobacteria;Rhizobiales;Rhizobiaceae;Shinella;
1	0	0	1	OSD188_6_14_RI	Bacteria;Proteobacteria;Alphaproteobacteria;Rhizobiales;Rhodobiaceae;uncultured;
3	1	1	5	OSD188_6_14_RI	Bacteria;Proteobacteria;Alphaproteobacteria;Rhodobacterales;Rhodobacteraceae;Celeribacter;
1	0	0	1	OSD188_6_14_RI	Bacteria;Proteobacteria;Alphaproteobacteria;Rhodobacterales;Rhodobacteraceae;Cribrihabitans;
1	0	0	1	OSD188_6_14_RI	Bacteria;Proteobacteria;Alphaproteobacteria;Rhodobacterales;Rhodobacteraceae;Defluviimonas;
1	0	0	1	OSD188_6_14_RI	Bacteria;Proteobacteria;Alphaproteobacteria;Rhodobacterales;Rhodobacteraceae;Epibacterium;
2	0	0	2	OSD188_6_14_RI	Bacteria;Proteobacteria;Alphaproteobacteria;Rhodobacterales;Rhodobacteraceae;Falsirhodobacter;
1	0	0	1	OSD188_6_14_RI	Bacteria;Proteobacteria;Alphaproteobacteria;Rhodobacterales;Rhodobacteraceae;Jannaschia;
1	0	0	1	OSD188_6_14_RI	Bacteria;Proteobacteria;Alphaproteobacteria;Rhodobacterales;Rhodobacteraceae;Labrenzia;
1	2	3	6	OSD188_6_14_RI	Bacteria;Proteobacteria;Alphaproteobacteria;Rhodobacterales;Rhodobacteraceae;Loktanella;
1	1	0	2	OSD188_6_14_RI	Bacteria;Proteobacteria;Alphaproteobacteria;Rhodobacterales;Rhodobacteraceae;Maritimibacter;
1	0	0	1	OSD188_6_14_RI	Bacteria;Proteobacteria;Alphaproteobacteria;Rhodobacterales;Rhodobacteraceae;Nautella;
1	2	0	3	OSD188_6_14_RI	Bacteria;Proteobacteria;Alphaproteobacteria;Rhodobacterales;Rhodobacteraceae;Octadecabacter;
1	0	0	1	OSD188_6_14_RI	Bacteria;Proteobacteria;Alphaproteobacteria;Rhodobacterales;Rhodobacteraceae;Paracoccus;
2	2	2	6	OSD188_6_14_RI	Bacteria;Proteobacteria;Alphaproteobacteria;Rhodobacterales;Rhodobacteraceae;Planktomarina;
2	0	0	2	OSD188_6_14_RI	Bacteria;Proteobacteria;Alphaproteobacteria;Rhodobacterales;Rhodobacteraceae;Planktotalea;
1	0	0	1	OSD188_6_14_RI	Bacteria;Proteobacteria;Alphaproteobacteria;Rhodobacterales;Rhodobacteraceae;Pseudorhodobacter;
1	0	0	1	OSD188_6_14_RI	Bacteria;Proteobacteria;Alphaproteobacteria;Rhodobacterales;Rhodobacteraceae;Pseudoruegeria;
1	0	0	1	OSD188_6_14_RI	Bacteria;Proteobacteria;Alphaproteobacteria;Rhodobacterales;Rhodobacteraceae;Roseibacterium;
1	0	0	1	OSD188_6_14_RI	Bacteria;Proteobacteria;Alphaproteobacteria;Rhodobacterales;Rhodobacteraceae;Roseobacter clade NAC11-7 lineage;
8	1	0	9	OSD188_6_14_RI	Bacteria;Proteobacteria;Alphaproteobacteria;Rhodobacterales;Rhodobacteraceae;Roseovarius;
2	2	2	6	OSD188_6_14_RI	Bacteria;Proteobacteria;Alphaproteobacteria;Rhodobacterales;Rhodobacteraceae;Ruegeria;
1	0	0	1	OSD188_6_14_RI	Bacteria;Proteobacteria;Alphaproteobacteria;Rhodobacterales;Rhodobacteraceae;Sediminimonas;
2	0	0	2	OSD188_6_14_RI	Bacteria;Proteobacteria;Alphaproteobacteria;Rhodobacterales;Rhodobacteraceae;Shimia;
3	3	0	6	OSD188_6_14_RI	Bacteria;Proteobacteria;Alphaproteobacteria;Rhodobacterales;Rhodobacteraceae;Sulfitobacter;
2	4	1	7	OSD188_6_14_RI	Bacteria;Proteobacteria;Alphaproteobacteria;Rhodobacterales;Rhodobacteraceae;Thalassobius;
199	394	457	1050	OSD188_6_14_RI	Bacteria;Proteobacteria;Alphaproteobacteria;Rhodobacterales;Rhodobacteraceae;uncultured;
4	10	4	18	OSD188_6_14_RI	Bacteria;Proteobacteria;Alphaproteobacteria;Rhodospirillales;AT-s3-44;
152	461	519	1132	OSD188_6_14_RI	Bacteria;Proteobacteria;Alphaproteobacteria;Rhodospirillales;Rhodospirillaceae;AEGEAN-169 marine group;
4	1	5	10	OSD188_6_14_RI	Bacteria;Proteobacteria;Alphaproteobacteria;Rhodospirillales;Rhodospirillaceae;Magnetospira;
22	24	17	63	OSD188_6_14_RI	Bacteria;Proteobacteria;Alphaproteobacteria;Rhodospirillales;Rhodospirillaceae;OM75 clade;
88	113	86	287	OSD188_6_14_RI	Bacteria;Proteobacteria;Alphaproteobacteria;Rhodospirillales;Rhodospirillaceae;uncultured;
2	0	0	2	OSD188_6_14_RI	Bacteria;Proteobacteria;Alphaproteobacteria;Rickettsiales;LWSR-14;
4	0	0	4	OSD188_6_14_RI	Bacteria;Proteobacteria;Alphaproteobacteria;Rickettsiales;MD3-55;
44	39	53	136	OSD188_6_14_RI	Bacteria;Proteobacteria;Alphaproteobacteria;Rickettsiales;Mitochondria;
5	0	0	5	OSD188_6_14_RI	Bacteria;Proteobacteria;Alphaproteobacteria;Rickettsiales;Rickettsiaceae;uncultured;
1	0	0	1	OSD188_6_14_RI	Bacteria;Proteobacteria;Alphaproteobacteria;Rickettsiales;Rickettsiales Incertae Sedis;Candidatus Hepatincola;
1	0	0	1	OSD188_6_14_RI	Bacteria;Proteobacteria;Alphaproteobacteria;Rickettsiales;Rickettsiales Incertae Sedis;uncultured;
87	139	129	355	OSD188_6_14_RI	Bacteria;Proteobacteria;Alphaproteobacteria;Rickettsiales;S25-593;
168	301	309	778	OSD188_6_14_RI	Bacteria;Proteobacteria;Alphaproteobacteria;Rickettsiales;SAR116 clade;
6	2	2	10	OSD188_6_14_RI	Bacteria;Proteobacteria;Alphaproteobacteria;Rickettsiales;SAR116 clade;Candidatus Puniceispirillum;
21	28	9	58	OSD188_6_14_RI	Bacteria;Proteobacteria;Alphaproteobacteria;SAR11 clade;
5	0	0	5	OSD188_6_14_RI	Bacteria;Proteobacteria;Alphaproteobacteria;SAR11 clade;Deep 1;
91	298	287	676	OSD188_6_14_RI	Bacteria;Proteobacteria;Alphaproteobacteria;SAR11 clade;Surface 1;
1	5	2	8	OSD188_6_14_RI	Bacteria;Proteobacteria;Alphaproteobacteria;SAR11 clade;Surface 1;Candidatus Pelagibacter;
13	76	88	177	OSD188_6_14_RI	Bacteria;Proteobacteria;Alphaproteobacteria;SAR11 clade;Surface 2;
2	1	0	3	OSD188_6_14_RI	Bacteria;Proteobacteria;Alphaproteobacteria;SAR11 clade;Surface 3;
36	62	76	174	OSD188_6_14_RI	Bacteria;Proteobacteria;Alphaproteobacteria;SAR11 clade;Surface 4;
1	0	0	1	OSD188_6_14_RI	Bacteria;Proteobacteria;Alphaproteobacteria;Sneathiellales;Sneathiellaceae;uncultured;
3	0	0	3	OSD188_6_14_RI	Bacteria;Proteobacteria;Alphaproteobacteria;Sphingomonadales;Erythrobacteraceae;Altererythrobacter;
28	69	87	184	OSD188_6_14_RI	Bacteria;Proteobacteria;Alphaproteobacteria;Sphingomonadales;Erythrobacteraceae;Erythrobacter;
4	1	3	8	OSD188_6_14_RI	Bacteria;Proteobacteria;Alphaproteobacteria;Sphingomonadales;Erythrobacteraceae;uncultured;
10	13	24	47	OSD188_6_14_RI	Bacteria;Proteobacteria;Alphaproteobacteria;Sphingomonadales;Sphingomonadaceae;Parasphingopyxis;
1	0	0	1	OSD188_6_14_RI	Bacteria;Proteobacteria;Alphaproteobacteria;Sphingomonadales;Sphingomonadaceae;Sphingobium;
3	2	2	7	OSD188_6_14_RI	Bacteria;Proteobacteria;Alphaproteobacteria;Sphingomonadales;Sphingomonadaceae;Sphingomonas;
1	0	2	3	OSD188_6_14_RI	Bacteria;Proteobacteria;Alphaproteobacteria;Sphingomonadales;Sphingomonadaceae;Sphingopyxis;
3	1	2	6	OSD188_6_14_RI	Bacteria;Proteobacteria;ARKICE-90;
13	11	4	28	OSD188_6_14_RI	Bacteria;Proteobacteria;Betaproteobacteria;Burkholderiales;Alcaligenaceae;MWH-UniP1 aquatic group;
1	0	0	1	OSD188_6_14_RI	Bacteria;Proteobacteria;Betaproteobacteria;Burkholderiales;Burkholderiaceae;Burkholderia-Paraburkholderia;
1	1	0	2	OSD188_6_14_RI	Bacteria;Proteobacteria;Betaproteobacteria;Burkholderiales;Burkholderiaceae;Limnobacter;
1	0	0	1	OSD188_6_14_RI	Bacteria;Proteobacteria;Betaproteobacteria;Burkholderiales;Burkholderiaceae;Polynucleobacter;
6	11	8	25	OSD188_6_14_RI	Bacteria;Proteobacteria;Betaproteobacteria;Burkholderiales;Burkholderiaceae;Ralstonia;
3	0	0	3	OSD188_6_14_RI	Bacteria;Proteobacteria;Betaproteobacteria;Burkholderiales;Oxalobacteraceae;Janthinobacterium;
3	5	2	10	OSD188_6_14_RI	Bacteria;Proteobacteria;Betaproteobacteria;Hydrogenophilales;Hydrogenophilaceae;uncultured;
1	0	0	1	OSD188_6_14_RI	Bacteria;Proteobacteria;Betaproteobacteria;Methylophilales;Methylophilaceae;OM43 clade;
1	0	0	1	OSD188_6_14_RI	Bacteria;Proteobacteria;Betaproteobacteria;Neisseriales;Neisseriaceae;Neisseria;
1	0	0	1	OSD188_6_14_RI	Bacteria;Proteobacteria;Betaproteobacteria;Rhodocyclales;Rhodocyclaceae;uncultured;
3	0	0	3	OSD188_6_14_RI	Bacteria;Proteobacteria;Deltaproteobacteria;Bdellovibrionales;Bacteriovoracaceae;Halobacteriovorax;
5	3	0	8	OSD188_6_14_RI	Bacteria;Proteobacteria;Deltaproteobacteria;Bdellovibrionales;Bacteriovoracaceae;Peredibacter;
3	3	8	14	OSD188_6_14_RI	Bacteria;Proteobacteria;Deltaproteobacteria;Bdellovibrionales;Bacteriovoracaceae;uncultured;
2	0	0	2	OSD188_6_14_RI	Bacteria;Proteobacteria;Deltaproteobacteria;Bdellovibrionales;Bdellovibrionaceae;Bdellovibrio;
53	25	17	95	OSD188_6_14_RI	Bacteria;Proteobacteria;Deltaproteobacteria;Bdellovibrionales;Bdellovibrionaceae;OM27 clade;
22	6	1	29	OSD188_6_14_RI	Bacteria;Proteobacteria;Deltaproteobacteria;Bradymonadales;
1	0	0	1	OSD188_6_14_RI	Bacteria;Proteobacteria;Deltaproteobacteria;Desulfobacterales;Desulfobulbaceae;Desulfocapsa;
1	0	0	1	OSD188_6_14_RI	Bacteria;Proteobacteria;Deltaproteobacteria;Desulfovibrionales;Desulfovibrionaceae;Desulfovibrio;
10	7	5	22	OSD188_6_14_RI	Bacteria;Proteobacteria;Deltaproteobacteria;Desulfurellales;Desulfurellaceae;H16;
1	0	0	1	OSD188_6_14_RI	Bacteria;Proteobacteria;Deltaproteobacteria;Desulfuromonadales;Desulfuromonadaceae;Desulfuromonas;
1	0	2	3	OSD188_6_14_RI	Bacteria;Proteobacteria;Deltaproteobacteria;Desulfuromonadales;Desulfuromonadaceae;Pelobacter;
1	0	0	1	OSD188_6_14_RI	Bacteria;Proteobacteria;Deltaproteobacteria;Desulfuromonadales;Geobacteraceae;Geothermobacter;
1	0	0	1	OSD188_6_14_RI	Bacteria;Proteobacteria;Deltaproteobacteria;Myxococcales;
2	0	0	2	OSD188_6_14_RI	Bacteria;Proteobacteria;Deltaproteobacteria;Myxococcales;BIrii41;
5	16	10	31	OSD188_6_14_RI	Bacteria;Proteobacteria;Deltaproteobacteria;Myxococcales;Blfdi19;
2	0	0	2	OSD188_6_14_RI	Bacteria;Proteobacteria;Deltaproteobacteria;Myxococcales;Eel-36e1D6;
4	3	0	7	OSD188_6_14_RI	Bacteria;Proteobacteria;Deltaproteobacteria;Myxococcales;Nannocystaceae;uncultured;
10	6	4	20	OSD188_6_14_RI	Bacteria;Proteobacteria;Deltaproteobacteria;Myxococcales;P3OB-42;
1	0	1	2	OSD188_6_14_RI	Bacteria;Proteobacteria;Deltaproteobacteria;Myxococcales;Sandaracinaceae;Sandaracinus;
13	1	2	16	OSD188_6_14_RI	Bacteria;Proteobacteria;Deltaproteobacteria;Myxococcales;Sandaracinaceae;uncultured;
10	5	4	19	OSD188_6_14_RI	Bacteria;Proteobacteria;Deltaproteobacteria;NB1-j;
49	32	22	103	OSD188_6_14_RI	Bacteria;Proteobacteria;Deltaproteobacteria;Oligoflexales;Oligoflexaceae;
50	65	79	194	OSD188_6_14_RI	Bacteria;Proteobacteria;Deltaproteobacteria;SAR324 clade(Marine group B);
5	4	5	14	OSD188_6_14_RI	Bacteria;Proteobacteria;Epsilonproteobacteria;Campylobacterales;Campylobacteraceae;Arcobacter;
4	0	0	4	OSD188_6_14_RI	Bacteria;Proteobacteria;Epsilonproteobacteria;Campylobacterales;Helicobacteraceae;Sulfurovum;
1	0	0	1	OSD188_6_14_RI	Bacteria;Proteobacteria;Gammaproteobacteria;Aeromonadales;Aeromonadaceae;Aeromonas;
4	5	1	10	OSD188_6_14_RI	Bacteria;Proteobacteria;Gammaproteobacteria;Aeromonadales;Aeromonadaceae;uncultured;
2	0	0	2	OSD188_6_14_RI	Bacteria;Proteobacteria;Gammaproteobacteria;Alteromonadales;Alteromonadaceae;Alteromonas;
3	1	0	4	OSD188_6_14_RI	Bacteria;Proteobacteria;Gammaproteobacteria;Alteromonadales;Alteromonadaceae;Marinobacter;
2	1	0	3	OSD188_6_14_RI	Bacteria;Proteobacteria;Gammaproteobacteria;Alteromonadales;Alteromonadaceae;Paraglaciecola;
3	1	0	4	OSD188_6_14_RI	Bacteria;Proteobacteria;Gammaproteobacteria;Alteromonadales;Colwelliaceae;Colwellia;
1	0	0	1	OSD188_6_14_RI	Bacteria;Proteobacteria;Gammaproteobacteria;Alteromonadales;Ferrimonadaceae;Ferrimonas;
7	3	0	10	OSD188_6_14_RI	Bacteria;Proteobacteria;Gammaproteobacteria;Alteromonadales;Pseudoalteromonadaceae;Pseudoalteromonas;
1	0	0	1	OSD188_6_14_RI	Bacteria;Proteobacteria;Gammaproteobacteria;Alteromonadales;Psychromonadaceae;Psychromonas;
4	2	0	6	OSD188_6_14_RI	Bacteria;Proteobacteria;Gammaproteobacteria;Alteromonadales;Shewanellaceae;Shewanella;
7	9	9	25	OSD188_6_14_RI	Bacteria;Proteobacteria;Gammaproteobacteria;Arenicellales;Arenicellaceae;Arenicella;
1	0	0	1	OSD188_6_14_RI	Bacteria;Proteobacteria;Gammaproteobacteria;Arenicellales;Arenicellaceae;uncultured;
2	0	0	2	OSD188_6_14_RI	Bacteria;Proteobacteria;Gammaproteobacteria;BD7-8 marine group;
2	0	0	2	OSD188_6_14_RI	Bacteria;Proteobacteria;Gammaproteobacteria;Cellvibrionales;Cellvibrionaceae;Candidatus Endobugula;
2	0	0	2	OSD188_6_14_RI	Bacteria;Proteobacteria;Gammaproteobacteria;Cellvibrionales;Cellvibrionaceae;Eionea;
1	1	0	2	OSD188_6_14_RI	Bacteria;Proteobacteria;Gammaproteobacteria;Cellvibrionales;Cellvibrionaceae;Maricurvus;
1	0	0	1	OSD188_6_14_RI	Bacteria;Proteobacteria;Gammaproteobacteria;Cellvibrionales;Cellvibrionaceae;Pseudoteredinibacter;
2	0	0	2	OSD188_6_14_RI	Bacteria;Proteobacteria;Gammaproteobacteria;Cellvibrionales;Cellvibrionaceae;Simiduia;
3	0	0	3	OSD188_6_14_RI	Bacteria;Proteobacteria;Gammaproteobacteria;Cellvibrionales;Cellvibrionaceae;uncultured;
7	11	2	20	OSD188_6_14_RI	Bacteria;Proteobacteria;Gammaproteobacteria;Cellvibrionales;Halieaceae;Haliea;
9	0	0	9	OSD188_6_14_RI	Bacteria;Proteobacteria;Gammaproteobacteria;Cellvibrionales;Halieaceae;Halioglobus;
2	1	1	4	OSD188_6_14_RI	Bacteria;Proteobacteria;Gammaproteobacteria;Cellvibrionales;Halieaceae;Luminiphilus;
42	83	48	173	OSD188_6_14_RI	Bacteria;Proteobacteria;Gammaproteobacteria;Cellvibrionales;Halieaceae;OM60(NOR5) clade;
9	7	2	18	OSD188_6_14_RI	Bacteria;Proteobacteria;Gammaproteobacteria;Cellvibrionales;Halieaceae;Parahaliea;
4	2	1	7	OSD188_6_14_RI	Bacteria;Proteobacteria;Gammaproteobacteria;Cellvibrionales;Halieaceae;Pseudohaliea;
2	1	0	3	OSD188_6_14_RI	Bacteria;Proteobacteria;Gammaproteobacteria;Cellvibrionales;Porticoccaceae;C1-B045;
26	42	59	127	OSD188_6_14_RI	Bacteria;Proteobacteria;Gammaproteobacteria;Cellvibrionales;Porticoccaceae;SAR92 clade;
12	5	4	21	OSD188_6_14_RI	Bacteria;Proteobacteria;Gammaproteobacteria;Cellvibrionales;Spongiibacteraceae;BD1-7 clade;
1	0	0	1	OSD188_6_14_RI	Bacteria;Proteobacteria;Gammaproteobacteria;Chromatiales;Ectothiorhodospiraceae;Thioalkalispira;
1	0	0	1	OSD188_6_14_RI	Bacteria;Proteobacteria;Gammaproteobacteria;Chromatiales;Ectothiorhodospiraceae;Thiogranum;
3	0	0	3	OSD188_6_14_RI	Bacteria;Proteobacteria;Gammaproteobacteria;Chromatiales;Granulosicoccaceae;Granulosicoccus;
41	50	62	153	OSD188_6_14_RI	Bacteria;Proteobacteria;Gammaproteobacteria;E01-9C-26 marine group;
1	0	0	1	OSD188_6_14_RI	Bacteria;Proteobacteria;Gammaproteobacteria;EC3;
1	0	0	1	OSD188_6_14_RI	Bacteria;Proteobacteria;Gammaproteobacteria;Enterobacteriales;Enterobacteriaceae;
1	0	0	1	OSD188_6_14_RI	Bacteria;Proteobacteria;Gammaproteobacteria;Enterobacteriales;Enterobacteriaceae;Cedecea;
32	14	3	49	OSD188_6_14_RI	Bacteria;Proteobacteria;Gammaproteobacteria;Enterobacteriales;Enterobacteriaceae;Citrobacter;
11	144	231	386	OSD188_6_14_RI	Bacteria;Proteobacteria;Gammaproteobacteria;Enterobacteriales;Enterobacteriaceae;Enterobacter;
7	3	2	12	OSD188_6_14_RI	Bacteria;Proteobacteria;Gammaproteobacteria;Enterobacteriales;Enterobacteriaceae;Escherichia-Shigella;
1	0	0	1	OSD188_6_14_RI	Bacteria;Proteobacteria;Gammaproteobacteria;Enterobacteriales;Enterobacteriaceae;Lelliottia;
1	0	1	2	OSD188_6_14_RI	Bacteria;Proteobacteria;Gammaproteobacteria;Enterobacteriales;Enterobacteriaceae;Pantoea;
1	0	0	1	OSD188_6_14_RI	Bacteria;Proteobacteria;Gammaproteobacteria;Enterobacteriales;Enterobacteriaceae;Phaseolibacter;
2	0	0	2	OSD188_6_14_RI	Bacteria;Proteobacteria;Gammaproteobacteria;Enterobacteriales;Enterobacteriaceae;Rahnella;
7	5	1	13	OSD188_6_14_RI	Bacteria;Proteobacteria;Gammaproteobacteria;Enterobacteriales;Enterobacteriaceae;Raoultella;
2	0	0	2	OSD188_6_14_RI	Bacteria;Proteobacteria;Gammaproteobacteria;Enterobacteriales;Enterobacteriaceae;Rosenbergiella;
37	48	84	169	OSD188_6_14_RI	Bacteria;Proteobacteria;Gammaproteobacteria;Enterobacteriales;Enterobacteriaceae;Serratia;
1	0	0	1	OSD188_6_14_RI	Bacteria;Proteobacteria;Gammaproteobacteria;Enterobacteriales;Enterobacteriaceae;uncultured;
3	13	2	18	OSD188_6_14_RI	Bacteria;Proteobacteria;Gammaproteobacteria;Enterobacteriales;Enterobacteriaceae;Yersinia;
5	4	1	10	OSD188_6_14_RI	Bacteria;Proteobacteria;Gammaproteobacteria;Gammaproteobacteria Incertae Sedis;Unknown Family;Marinicella;
1	0	0	1	OSD188_6_14_RI	Bacteria;Proteobacteria;Gammaproteobacteria;Gammaproteobacteria Incertae Sedis;Unknown Family;Thiohalophilus;
34	27	37	98	OSD188_6_14_RI	Bacteria;Proteobacteria;Gammaproteobacteria;Gammaproteobacteria Incertae Sedis;Unknown Family;uncultured;
5	0	0	5	OSD188_6_14_RI	Bacteria;Proteobacteria;Gammaproteobacteria;HTA4;
42	35	39	116	OSD188_6_14_RI	Bacteria;Proteobacteria;Gammaproteobacteria;KI89A clade;
26	3	1	30	OSD188_6_14_RI	Bacteria;Proteobacteria;Gammaproteobacteria;Legionellales;Coxiellaceae;Coxiella;
7	2	0	9	OSD188_6_14_RI	Bacteria;Proteobacteria;Gammaproteobacteria;Legionellales;Legionellaceae;uncultured;
5	1	0	6	OSD188_6_14_RI	Bacteria;Proteobacteria;Gammaproteobacteria;Oceanospirillales;
3	1	0	4	OSD188_6_14_RI	Bacteria;Proteobacteria;Gammaproteobacteria;Oceanospirillales;Alcanivoracaceae;Kangiella;
2	0	0	2	OSD188_6_14_RI	Bacteria;Proteobacteria;Gammaproteobacteria;Oceanospirillales;CrystalBog021C3;
3	0	0	3	OSD188_6_14_RI	Bacteria;Proteobacteria;Gammaproteobacteria;Oceanospirillales;Hahellaceae;Endozoicomonas;
1	0	0	1	OSD188_6_14_RI	Bacteria;Proteobacteria;Gammaproteobacteria;Oceanospirillales;Hahellaceae;Kistimonas;
3	2	0	5	OSD188_6_14_RI	Bacteria;Proteobacteria;Gammaproteobacteria;Oceanospirillales;Halomonadaceae;Halomonas;
1	0	0	1	OSD188_6_14_RI	Bacteria;Proteobacteria;Gammaproteobacteria;Oceanospirillales;Halomonadaceae;Salinicola;
3	0	0	3	OSD188_6_14_RI	Bacteria;Proteobacteria;Gammaproteobacteria;Oceanospirillales;JL-ETNP-Y6;
4	0	1	5	OSD188_6_14_RI	Bacteria;Proteobacteria;Gammaproteobacteria;Oceanospirillales;Litoricolaceae;Litoricola;
1	0	0	1	OSD188_6_14_RI	Bacteria;Proteobacteria;Gammaproteobacteria;Oceanospirillales;Nit5Au0613-695;
3	2	0	5	OSD188_6_14_RI	Bacteria;Proteobacteria;Gammaproteobacteria;Oceanospirillales;Oceanospirillaceae;Balneatrix;
11	6	3	20	OSD188_6_14_RI	Bacteria;Proteobacteria;Gammaproteobacteria;Oceanospirillales;Oceanospirillaceae;Marinobacterium;
3	2	0	5	OSD188_6_14_RI	Bacteria;Proteobacteria;Gammaproteobacteria;Oceanospirillales;Oceanospirillaceae;Marinomonas;
1	1	0	2	OSD188_6_14_RI	Bacteria;Proteobacteria;Gammaproteobacteria;Oceanospirillales;Oceanospirillaceae;Motiliproteus;
1	0	0	1	OSD188_6_14_RI	Bacteria;Proteobacteria;Gammaproteobacteria;Oceanospirillales;Oceanospirillaceae;Oceaniserpentilla;
2	0	0	2	OSD188_6_14_RI	Bacteria;Proteobacteria;Gammaproteobacteria;Oceanospirillales;Oceanospirillaceae;Oleispira;
26	43	65	134	OSD188_6_14_RI	Bacteria;Proteobacteria;Gammaproteobacteria;Oceanospirillales;Oceanospirillaceae;Pseudohongiella;
3	0	0	3	OSD188_6_14_RI	Bacteria;Proteobacteria;Gammaproteobacteria;Oceanospirillales;Oleiphilaceae;Oleiphilus;
30	37	33	100	OSD188_6_14_RI	Bacteria;Proteobacteria;Gammaproteobacteria;Oceanospirillales;OM182 clade;
415	901	1167	2483	OSD188_6_14_RI	Bacteria;Proteobacteria;Gammaproteobacteria;Oceanospirillales;SAR86 clade;
3	1	0	4	OSD188_6_14_RI	Bacteria;Proteobacteria;Gammaproteobacteria;Oceanospirillales;SS1-B-06-26;
9	15	18	42	OSD188_6_14_RI	Bacteria;Proteobacteria;Gammaproteobacteria;Oceanospirillales;ZD0405;
4	2	0	6	OSD188_6_14_RI	Bacteria;Proteobacteria;Gammaproteobacteria;Pseudomonadales;Moraxellaceae;Acinetobacter;
2	0	0	2	OSD188_6_14_RI	Bacteria;Proteobacteria;Gammaproteobacteria;Pseudomonadales;Moraxellaceae;Enhydrobacter;
3	2	0	5	OSD188_6_14_RI	Bacteria;Proteobacteria;Gammaproteobacteria;Pseudomonadales;Moraxellaceae;Psychrobacter;
14	11	9	34	OSD188_6_14_RI	Bacteria;Proteobacteria;Gammaproteobacteria;Pseudomonadales;Pseudomonadaceae;Pseudomonas;
48	101	130	279	OSD188_6_14_RI	Bacteria;Proteobacteria;Gammaproteobacteria;Salinisphaerales;Salinisphaeraceae;ZD0417 marine group;
1	0	0	1	OSD188_6_14_RI	Bacteria;Proteobacteria;Gammaproteobacteria;Sva0071;
1	0	0	1	OSD188_6_14_RI	Bacteria;Proteobacteria;Gammaproteobacteria;Thiotrichales;Francisellaceae;Francisella;
1	0	0	1	OSD188_6_14_RI	Bacteria;Proteobacteria;Gammaproteobacteria;Thiotrichales;Piscirickettsiaceae;Marine Methylotrophic Group 3;
1	0	0	1	OSD188_6_14_RI	Bacteria;Proteobacteria;Gammaproteobacteria;Thiotrichales;Piscirickettsiaceae;uncultured;
1	1	0	2	OSD188_6_14_RI	Bacteria;Proteobacteria;Gammaproteobacteria;Thiotrichales;Thiotrichaceae;Cocleimonas;
2	0	0	2	OSD188_6_14_RI	Bacteria;Proteobacteria;Gammaproteobacteria;Thiotrichales;Thiotrichaceae;Leucothrix;
5	7	10	22	OSD188_6_14_RI	Bacteria;Proteobacteria;Gammaproteobacteria;Thiotrichales;Thiotrichaceae;Thiothrix;
1	0	0	1	OSD188_6_14_RI	Bacteria;Proteobacteria;Gammaproteobacteria;Thiotrichales;Thiotrichaceae;uncultured;
2	0	0	2	OSD188_6_14_RI	Bacteria;Proteobacteria;Gammaproteobacteria;Thiotrichales;Thiotrichales Incertae Sedis;Caedibacter;
3	1	1	5	OSD188_6_14_RI	Bacteria;Proteobacteria;Gammaproteobacteria;Thiotrichales;Thiotrichales Incertae Sedis;Candidatus Endoecteinascidia;
1	1	0	2	OSD188_6_14_RI	Bacteria;Proteobacteria;Gammaproteobacteria;Thiotrichales;uncultured;
5	4	1	10	OSD188_6_14_RI	Bacteria;Proteobacteria;Gammaproteobacteria;uncultured;
1	0	0	1	OSD188_6_14_RI	Bacteria;Proteobacteria;Gammaproteobacteria;Vibrionales;Vibrionaceae;Enterovibrio;
2	1	1	4	OSD188_6_14_RI	Bacteria;Proteobacteria;Gammaproteobacteria;Vibrionales;Vibrionaceae;Grimontia;
7	7	2	16	OSD188_6_14_RI	Bacteria;Proteobacteria;Gammaproteobacteria;Vibrionales;Vibrionaceae;Photobacterium;
3	2	1	6	OSD188_6_14_RI	Bacteria;Proteobacteria;Gammaproteobacteria;Vibrionales;Vibrionaceae;uncultured;
12	33	31	76	OSD188_6_14_RI	Bacteria;Proteobacteria;Gammaproteobacteria;Vibrionales;Vibrionaceae;Vibrio;
22	22	10	54	OSD188_6_14_RI	Bacteria;Proteobacteria;Gammaproteobacteria;Xanthomonadales;JTB255 marine benthic group;
4	1	1	6	OSD188_6_14_RI	Bacteria;Proteobacteria;Gammaproteobacteria;Xanthomonadales;uncultured;
1	0	0	1	OSD188_6_14_RI	Bacteria;Proteobacteria;Gammaproteobacteria;Xanthomonadales;Xanthomonadaceae;Pseudoxanthomonas;
10	10	8	28	OSD188_6_14_RI	Bacteria;Proteobacteria;Gammaproteobacteria;Xanthomonadales;Xanthomonadaceae;Stenotrophomonas;
3	3	0	6	OSD188_6_14_RI	Bacteria;Proteobacteria;JdFBHP3;
9	13	6	28	OSD188_6_14_RI	Bacteria;Proteobacteria;SPOTSOCT00m83;
17	17	29	63	OSD188_6_14_RI	Bacteria;SBR1093;
2	0	0	2	OSD188_6_14_RI	Bacteria;Spirochaetae;Spirochaetes;Spirochaetales;Spirochaetaceae;Spirochaeta 2;
2	0	0	2	OSD188_6_14_RI	Bacteria;SR1 (Absconditabacteria);
2	0	0	2	OSD188_6_14_RI	Bacteria;TM6 (Dependentiae);
10	10	3	23	OSD188_6_14_RI	Bacteria;Verrucomicrobia;Arctic97B-4 marine group;
5	9	12	26	OSD188_6_14_RI	Bacteria;Verrucomicrobia;OPB35 soil group;
3	1	4	8	OSD188_6_14_RI	Bacteria;Verrucomicrobia;Opitutae;A714019;
16	19	17	52	OSD188_6_14_RI	Bacteria;Verrucomicrobia;Opitutae;MB11C04 marine group;
2	0	0	2	OSD188_6_14_RI	Bacteria;Verrucomicrobia;Opitutae;Puniceicoccales;Puniceicoccaceae;Cerasicoccus;
63	137	205	405	OSD188_6_14_RI	Bacteria;Verrucomicrobia;Opitutae;Puniceicoccales;Puniceicoccaceae;Coraliomargarita;
1	1	0	2	OSD188_6_14_RI	Bacteria;Verrucomicrobia;Opitutae;Puniceicoccales;Puniceicoccaceae;Lentimonas;
2	3	1	6	OSD188_6_14_RI	Bacteria;Verrucomicrobia;Opitutae;Puniceicoccales;Puniceicoccaceae;Pelagicoccus;
2	0	0	2	OSD188_6_14_RI	Bacteria;Verrucomicrobia;Opitutae;Puniceicoccales;Puniceicoccaceae;uncultured;
3	6	7	16	OSD188_6_14_RI	Bacteria;Verrucomicrobia;R76-B128;
29	43	46	118	OSD188_6_14_RI	Bacteria;Verrucomicrobia;Verrucomicrobiae;Verrucomicrobiales;DEV007;
6	5	5	16	OSD188_6_14_RI	Bacteria;Verrucomicrobia;Verrucomicrobiae;Verrucomicrobiales;Rubritaleaceae;Rubritalea;
1	0	0	1	OSD188_6_14_RI	Bacteria;Verrucomicrobia;Verrucomicrobiae;Verrucomicrobiales;Verrucomicrobiaceae;Haloferula;
2	0	0	2	OSD188_6_14_RI	Bacteria;Verrucomicrobia;Verrucomicrobiae;Verrucomicrobiales;Verrucomicrobiaceae;Persicirhabdus;
12	14	15	41	OSD188_6_14_RI	Bacteria;Verrucomicrobia;Verrucomicrobiae;Verrucomicrobiales;Verrucomicrobiaceae;Roseibacillus;
3	0	2	5	OSD188_6_14_RI	Bacteria;Verrucomicrobia;Verrucomicrobiae;Verrucomicrobiales;Verrucomicrobiaceae;uncultured;
2	0	0	2	OSD188_6_14_RI	Bacteria;Verrucomicrobia;WCHB1-41;
103	105	117	325	OSD188_6_14_RI	No Relative
1	0	0	1	OSD189_6_14_YNG	Archaea;Euryarchaeota;Halobacteria;Halobacteriales;Halobacteriaceae;Halococcus;
1	0	0	1	OSD189_6_14_YNG	Archaea;Euryarchaeota;Halobacteria;Halobacteriales;Halobacteriaceae;Halorubrum;
1	0	0	1	OSD189_6_14_YNG	Archaea;Euryarchaeota;Halobacteria;Halobacteriales;Halobacteriaceae;uncultured;
180	555	738	1473	OSD189_6_14_YNG	Archaea;Euryarchaeota;Thermoplasmata;Thermoplasmatales;Marine Group II;
9	60	131	200	OSD189_6_14_YNG	Archaea;Euryarchaeota;Thermoplasmata;Thermoplasmatales;Marine Group III;
2	1	0	3	OSD189_6_14_YNG	Archaea;Thaumarchaeota;Marine Group I;Unknown Order;Unknown Family;Candidatus Nitrosopelagicus;
1	0	0	1	OSD189_6_14_YNG	Archaea;Thaumarchaeota;Marine Group I;Unknown Order;Unknown Family;Candidatus Nitrosopumilus;
3	1	4	8	OSD189_6_14_YNG	Archaea;Woesearchaeota (DHVEG-6);
3	2	6	11	OSD189_6_14_YNG	Bacteria;Actinobacteria;Acidimicrobiia;Acidimicrobiales;Acidimicrobiaceae;uncultured;
135	459	686	1280	OSD189_6_14_YNG	Bacteria;Actinobacteria;Acidimicrobiia;Acidimicrobiales;OM1 clade;Candidatus Actinomarina;
65	110	140	315	OSD189_6_14_YNG	Bacteria;Actinobacteria;Acidimicrobiia;Acidimicrobiales;Sva0996 marine group;
1	0	1	2	OSD189_6_14_YNG	Bacteria;Actinobacteria;Actinobacteria;Corynebacteriales;Nocardiaceae;Williamsia;
1	0	0	1	OSD189_6_14_YNG	Bacteria;Actinobacteria;Actinobacteria;Micrococcales;Micrococcaceae;Rothia;
1	0	0	1	OSD189_6_14_YNG	Bacteria;Actinobacteria;Actinobacteria;PeM15;
2	2	0	4	OSD189_6_14_YNG	Bacteria;Bacteroidetes;Bacteroidetes Incertae Sedis;Order II;Rhodothermaceae;Rubrivirga;
5	6	7	18	OSD189_6_14_YNG	Bacteria;Bacteroidetes;Bacteroidetes Incertae Sedis;Order III;Unknown Family;Balneola;
1	0	0	1	OSD189_6_14_YNG	Bacteria;Bacteroidetes;Bacteroidetes Incertae Sedis;Order III;Unknown Family;Gracilimonas;
1	0	0	1	OSD189_6_14_YNG	Bacteria;Bacteroidetes;Cytophagia;Cytophagales;Flammeovirgaceae;Candidatus Amoebophilus;
1	0	1	2	OSD189_6_14_YNG	Bacteria;Bacteroidetes;Cytophagia;Cytophagales;Flammeovirgaceae;Cesiribacter;
1	0	1	2	OSD189_6_14_YNG	Bacteria;Bacteroidetes;Cytophagia;Cytophagales;Flammeovirgaceae;Ekhidna;
2	0	0	2	OSD189_6_14_YNG	Bacteria;Bacteroidetes;Cytophagia;Cytophagales;Flammeovirgaceae;Fabibacter;
10	25	25	60	OSD189_6_14_YNG	Bacteria;Bacteroidetes;Cytophagia;Cytophagales;Flammeovirgaceae;Marinoscillum;
1	0	0	1	OSD189_6_14_YNG	Bacteria;Bacteroidetes;Cytophagia;Cytophagales;Flammeovirgaceae;Reichenbachiella;
2	0	0	2	OSD189_6_14_YNG	Bacteria;Bacteroidetes;Cytophagia;Cytophagales;Flammeovirgaceae;uncultured;
3	0	0	3	OSD189_6_14_YNG	Bacteria;Bacteroidetes;Flavobacteriia;Flavobacteriales;Cryomorphaceae;Crocinitomix;
8	24	26	58	OSD189_6_14_YNG	Bacteria;Bacteroidetes;Flavobacteriia;Flavobacteriales;Cryomorphaceae;Fluviicola;
1	0	0	1	OSD189_6_14_YNG	Bacteria;Bacteroidetes;Flavobacteriia;Flavobacteriales;Cryomorphaceae;NS10 marine group;
1	0	0	1	OSD189_6_14_YNG	Bacteria;Bacteroidetes;Flavobacteriia;Flavobacteriales;Cryomorphaceae;Owenweeksia;
1	0	0	1	OSD189_6_14_YNG	Bacteria;Bacteroidetes;Flavobacteriia;Flavobacteriales;Cryomorphaceae;Salinirepens;
14	12	10	36	OSD189_6_14_YNG	Bacteria;Bacteroidetes;Flavobacteriia;Flavobacteriales;Cryomorphaceae;uncultured;
1	0	0	1	OSD189_6_14_YNG	Bacteria;Bacteroidetes;Flavobacteriia;Flavobacteriales;Flavobacteriaceae;Aquibacter;
2	8	9	19	OSD189_6_14_YNG	Bacteria;Bacteroidetes;Flavobacteriia;Flavobacteriales;Flavobacteriaceae;Formosa;
1	0	0	1	OSD189_6_14_YNG	Bacteria;Bacteroidetes;Flavobacteriia;Flavobacteriales;Flavobacteriaceae;Kordia;
23	75	90	188	OSD189_6_14_YNG	Bacteria;Bacteroidetes;Flavobacteriia;Flavobacteriales;Flavobacteriaceae;NS2b marine group;
87	171	194	452	OSD189_6_14_YNG	Bacteria;Bacteroidetes;Flavobacteriia;Flavobacteriales;Flavobacteriaceae;NS4 marine group;
125	298	446	869	OSD189_6_14_YNG	Bacteria;Bacteroidetes;Flavobacteriia;Flavobacteriales;Flavobacteriaceae;NS5 marine group;
2	0	0	2	OSD189_6_14_YNG	Bacteria;Bacteroidetes;Flavobacteriia;Flavobacteriales;Flavobacteriaceae;Pseudofulvibacter;
1	0	0	1	OSD189_6_14_YNG	Bacteria;Bacteroidetes;Flavobacteriia;Flavobacteriales;Flavobacteriaceae;Salinimicrobium;
3	3	3	9	OSD189_6_14_YNG	Bacteria;Bacteroidetes;Flavobacteriia;Flavobacteriales;Flavobacteriaceae;Tenacibaculum;
1	0	0	1	OSD189_6_14_YNG	Bacteria;Bacteroidetes;Flavobacteriia;Flavobacteriales;Flavobacteriaceae;uncultured;
13	42	56	111	OSD189_6_14_YNG	Bacteria;Bacteroidetes;Flavobacteriia;Flavobacteriales;NS7 marine group;
68	122	115	305	OSD189_6_14_YNG	Bacteria;Bacteroidetes;Flavobacteriia;Flavobacteriales;NS9 marine group;
3	0	0	3	OSD189_6_14_YNG	Bacteria;Bacteroidetes;Sphingobacteriia;Sphingobacteriales;Saprospiraceae;Aureispira;
4	5	2	11	OSD189_6_14_YNG	Bacteria;Bacteroidetes;Sphingobacteriia;Sphingobacteriales;Saprospiraceae;uncultured;
1	0	0	1	OSD189_6_14_YNG	Bacteria;Chlamydiae;Chlamydiae;Chlamydiales;Simkaniaceae;uncultured;
6	8	0	14	OSD189_6_14_YNG	Bacteria;Chlorobi;Chlorobia;Chlorobiales;Chlorobiaceae;Chlorobium;
40	96	126	262	OSD189_6_14_YNG	Bacteria;Chloroflexi;SAR202 clade;
300	517	517	1334	OSD189_6_14_YNG	Bacteria;Cyanobacteria;Chloroplast;
1	0	0	1	OSD189_6_14_YNG	Bacteria;Cyanobacteria;Cyanobacteria;SubsectionI;FamilyI;
279	760	1199	2238	OSD189_6_14_YNG	Bacteria;Cyanobacteria;Cyanobacteria;SubsectionI;FamilyI;Prochlorococcus;
249	868	2314	3431	OSD189_6_14_YNG	Bacteria;Cyanobacteria;Cyanobacteria;SubsectionI;FamilyI;Synechococcus;
8	19	24	51	OSD189_6_14_YNG	Bacteria;Cyanobacteria;Cyanobacteria;SubsectionIII;FamilyI;Oscillatoria;
14	49	41	104	OSD189_6_14_YNG	Bacteria;Cyanobacteria;Cyanobacteria;SubsectionIII;FamilyI;Trichodesmium;
2	0	0	2	OSD189_6_14_YNG	Bacteria;Cyanobacteria;Cyanobacteria;SubsectionIV;FamilyII;Calothrix;
1	0	0	1	OSD189_6_14_YNG	Bacteria;Cyanobacteria;Melainabacteria;Caenarcaniphilales;
11	4	0	15	OSD189_6_14_YNG	Bacteria;Cyanobacteria;ML635J-21;
1	0	0	1	OSD189_6_14_YNG	Bacteria;Elusimicrobia;Elusimicrobia;Lineage IIb;
2	0	0	2	OSD189_6_14_YNG	Bacteria;Firmicutes;Bacilli;Bacillales;Bacillaceae;Bacillus;
1	0	0	1	OSD189_6_14_YNG	Bacteria;Firmicutes;Bacilli;Bacillales;Staphylococcaceae;Staphylococcus;
1	0	0	1	OSD189_6_14_YNG	Bacteria;Firmicutes;Bacilli;Lactobacillales;Carnobacteriaceae;Carnobacterium;
1	0	0	1	OSD189_6_14_YNG	Bacteria;Firmicutes;Bacilli;Lactobacillales;Streptococcaceae;Streptococcus;
1	0	1	2	OSD189_6_14_YNG	Bacteria;Firmicutes;Clostridia;Halanaerobiales;ODP1230B8.23;
1	0	0	1	OSD189_6_14_YNG	Bacteria;Gemmatimonadetes;BD2-11 terrestrial group;
1	0	0	1	OSD189_6_14_YNG	Bacteria;Gracilibacteria;
1	2	2	5	OSD189_6_14_YNG	Bacteria;Lentisphaerae;Lentisphaeria;Lentisphaerales;Lentisphaeraceae;Lentisphaera;
210	487	652	1349	OSD189_6_14_YNG	Bacteria;Marinimicrobia (SAR406 clade);
1	0	0	1	OSD189_6_14_YNG	Bacteria;Parcubacteria;
1	0	0	1	OSD189_6_14_YNG	Bacteria;PAUC34f;
4	1	0	5	OSD189_6_14_YNG	Bacteria;Planctomycetes;OM190;
6	6	0	12	OSD189_6_14_YNG	Bacteria;Planctomycetes;Phycisphaerae;Phycisphaerales;Phycisphaeraceae;CL500-3;
1	1	3	5	OSD189_6_14_YNG	Bacteria;Planctomycetes;Phycisphaerae;Phycisphaerales;Phycisphaeraceae;FS140-16B-02 marine group;
2	4	8	14	OSD189_6_14_YNG	Bacteria;Planctomycetes;Phycisphaerae;Phycisphaerales;Phycisphaeraceae;Urania-1B-19 marine sediment group;
1	1	1	3	OSD189_6_14_YNG	Bacteria;Planctomycetes;Pla3 lineage;
1	0	0	1	OSD189_6_14_YNG	Bacteria;Planctomycetes;Planctomycetacia;Planctomycetales;Planctomycetaceae;Blastopirellula;
1	0	0	1	OSD189_6_14_YNG	Bacteria;Planctomycetes;Planctomycetacia;Planctomycetales;Planctomycetaceae;Planctomyces;
1	0	0	1	OSD189_6_14_YNG	Bacteria;Planctomycetes;Planctomycetacia;Planctomycetales;Planctomycetaceae;Rhodopirellula;
1	3	3	7	OSD189_6_14_YNG	Bacteria;Planctomycetes;Planctomycetacia;Planctomycetales;Planctomycetaceae;Rubripirellula;
2	0	0	2	OSD189_6_14_YNG	Bacteria;Planctomycetes;Planctomycetacia;Planctomycetales;Planctomycetaceae;uncultured;
1	0	0	1	OSD189_6_14_YNG	Bacteria;Proteobacteria;Alphaproteobacteria;Caulobacterales;Caulobacteraceae;Caulobacter;
1	0	0	1	OSD189_6_14_YNG	Bacteria;Proteobacteria;Alphaproteobacteria;Caulobacterales;Hyphomonadaceae;Oceanicaulis;
1	0	0	1	OSD189_6_14_YNG	Bacteria;Proteobacteria;Alphaproteobacteria;Kordiimonadales;Kordiimonadaceae;Kordiimonas;
2	0	0	2	OSD189_6_14_YNG	Bacteria;Proteobacteria;Alphaproteobacteria;Parvularculales;Parvularculaceae;Parvularcula;
1	0	0	1	OSD189_6_14_YNG	Bacteria;Proteobacteria;Alphaproteobacteria;Rhizobiales;Bradyrhizobiaceae;Bradyrhizobium;
1	0	0	1	OSD189_6_14_YNG	Bacteria;Proteobacteria;Alphaproteobacteria;Rhizobiales;Methylobacteriaceae;Methylobacterium;
6	10	10	26	OSD189_6_14_YNG	Bacteria;Proteobacteria;Alphaproteobacteria;Rhizobiales;OCS116 clade;
1	0	0	1	OSD189_6_14_YNG	Bacteria;Proteobacteria;Alphaproteobacteria;Rhizobiales;Phyllobacteriaceae;Mesorhizobium;
1	0	0	1	OSD189_6_14_YNG	Bacteria;Proteobacteria;Alphaproteobacteria;Rhizobiales;Phyllobacteriaceae;Oricola;
1	0	0	1	OSD189_6_14_YNG	Bacteria;Proteobacteria;Alphaproteobacteria;Rhizobiales;Phyllobacteriaceae;uncultured;
59	119	131	309	OSD189_6_14_YNG	Bacteria;Proteobacteria;Alphaproteobacteria;Rhizobiales;PS1 clade;
4	0	0	4	OSD189_6_14_YNG	Bacteria;Proteobacteria;Alphaproteobacteria;Rhizobiales;Rhodobiaceae;Rhodobium;
1	1	0	2	OSD189_6_14_YNG	Bacteria;Proteobacteria;Alphaproteobacteria;Rhodobacterales;Rhodobacteraceae;Ascidiaceihabitans;
1	14	53	68	OSD189_6_14_YNG	Bacteria;Proteobacteria;Alphaproteobacteria;Rhodobacterales;Rhodobacteraceae;Cribrihabitans;
1	0	0	1	OSD189_6_14_YNG	Bacteria;Proteobacteria;Alphaproteobacteria;Rhodobacterales;Rhodobacteraceae;Defluviimonas;
1	0	0	1	OSD189_6_14_YNG	Bacteria;Proteobacteria;Alphaproteobacteria;Rhodobacterales;Rhodobacteraceae;Halocynthiibacter;
1	3	0	4	OSD189_6_14_YNG	Bacteria;Proteobacteria;Alphaproteobacteria;Rhodobacterales;Rhodobacteraceae;Loktanella;
1	1	0	2	OSD189_6_14_YNG	Bacteria;Proteobacteria;Alphaproteobacteria;Rhodobacterales;Rhodobacteraceae;Maritimibacter;
1	0	0	1	OSD189_6_14_YNG	Bacteria;Proteobacteria;Alphaproteobacteria;Rhodobacterales;Rhodobacteraceae;Oceanicola;
2	0	0	2	OSD189_6_14_YNG	Bacteria;Proteobacteria;Alphaproteobacteria;Rhodobacterales;Rhodobacteraceae;Paracoccus;
1	1	0	2	OSD189_6_14_YNG	Bacteria;Proteobacteria;Alphaproteobacteria;Rhodobacterales;Rhodobacteraceae;Roseibacterium;
1	0	0	1	OSD189_6_14_YNG	Bacteria;Proteobacteria;Alphaproteobacteria;Rhodobacterales;Rhodobacteraceae;Roseibium;
1	0	0	1	OSD189_6_14_YNG	Bacteria;Proteobacteria;Alphaproteobacteria;Rhodobacterales;Rhodobacteraceae;Roseisalinus;
8	4	0	12	OSD189_6_14_YNG	Bacteria;Proteobacteria;Alphaproteobacteria;Rhodobacterales;Rhodobacteraceae;Roseovarius;
3	1	0	4	OSD189_6_14_YNG	Bacteria;Proteobacteria;Alphaproteobacteria;Rhodobacterales;Rhodobacteraceae;Sediminimonas;
1	1	0	2	OSD189_6_14_YNG	Bacteria;Proteobacteria;Alphaproteobacteria;Rhodobacterales;Rhodobacteraceae;Sulfitobacter;
198	482	580	1260	OSD189_6_14_YNG	Bacteria;Proteobacteria;Alphaproteobacteria;Rhodobacterales;Rhodobacteraceae;uncultured;
1	0	1	2	OSD189_6_14_YNG	Bacteria;Proteobacteria;Alphaproteobacteria;Rhodospirillales;AT-s3-44;
171	557	717	1445	OSD189_6_14_YNG	Bacteria;Proteobacteria;Alphaproteobacteria;Rhodospirillales;Rhodospirillaceae;AEGEAN-169 marine group;
1	1	0	2	OSD189_6_14_YNG	Bacteria;Proteobacteria;Alphaproteobacteria;Rhodospirillales;Rhodospirillaceae;Nisaea;
13	20	25	58	OSD189_6_14_YNG	Bacteria;Proteobacteria;Alphaproteobacteria;Rhodospirillales;Rhodospirillaceae;OM75 clade;
1	0	0	1	OSD189_6_14_YNG	Bacteria;Proteobacteria;Alphaproteobacteria;Rhodospirillales;Rhodospirillaceae;Skermanella;
1	0	0	1	OSD189_6_14_YNG	Bacteria;Proteobacteria;Alphaproteobacteria;Rhodospirillales;Rhodospirillaceae;Thalassospira;
63	125	90	278	OSD189_6_14_YNG	Bacteria;Proteobacteria;Alphaproteobacteria;Rhodospirillales;Rhodospirillaceae;uncultured;
4	1	0	5	OSD189_6_14_YNG	Bacteria;Proteobacteria;Alphaproteobacteria;Rickettsiales;LWSR-14;
5	1	2	8	OSD189_6_14_YNG	Bacteria;Proteobacteria;Alphaproteobacteria;Rickettsiales;MD3-55;
29	31	31	91	OSD189_6_14_YNG	Bacteria;Proteobacteria;Alphaproteobacteria;Rickettsiales;Mitochondria;
3	1	0	4	OSD189_6_14_YNG	Bacteria;Proteobacteria;Alphaproteobacteria;Rickettsiales;Rickettsiaceae;Candidatus Cryptoprodotis;
1	0	0	1	OSD189_6_14_YNG	Bacteria;Proteobacteria;Alphaproteobacteria;Rickettsiales;Rickettsiaceae;Orientia;
7	4	1	12	OSD189_6_14_YNG	Bacteria;Proteobacteria;Alphaproteobacteria;Rickettsiales;Rickettsiaceae;uncultured;
119	260	285	664	OSD189_6_14_YNG	Bacteria;Proteobacteria;Alphaproteobacteria;Rickettsiales;S25-593;
313	753	861	1927	OSD189_6_14_YNG	Bacteria;Proteobacteria;Alphaproteobacteria;Rickettsiales;SAR116 clade;
11	32	52	95	OSD189_6_14_YNG	Bacteria;Proteobacteria;Alphaproteobacteria;Rickettsiales;SAR116 clade;Candidatus Puniceispirillum;
18	11	5	34	OSD189_6_14_YNG	Bacteria;Proteobacteria;Alphaproteobacteria;SAR11 clade;
2	0	0	2	OSD189_6_14_YNG	Bacteria;Proteobacteria;Alphaproteobacteria;SAR11 clade;Chesapeake-Delaware Bay;
2	1	0	3	OSD189_6_14_YNG	Bacteria;Proteobacteria;Alphaproteobacteria;SAR11 clade;Deep 1;
116	523	609	1248	OSD189_6_14_YNG	Bacteria;Proteobacteria;Alphaproteobacteria;SAR11 clade;Surface 1;
32	116	21	169	OSD189_6_14_YNG	Bacteria;Proteobacteria;Alphaproteobacteria;SAR11 clade;Surface 2;
4	39	165	208	OSD189_6_14_YNG	Bacteria;Proteobacteria;Alphaproteobacteria;SAR11 clade;Surface 3;
57	175	223	455	OSD189_6_14_YNG	Bacteria;Proteobacteria;Alphaproteobacteria;SAR11 clade;Surface 4;
1	0	0	1	OSD189_6_14_YNG	Bacteria;Proteobacteria;Alphaproteobacteria;Sphingomonadales;Erythrobacteraceae;
1	0	0	1	OSD189_6_14_YNG	Bacteria;Proteobacteria;Alphaproteobacteria;Sphingomonadales;Erythrobacteraceae;Altererythrobacter;
7	4	0	11	OSD189_6_14_YNG	Bacteria;Proteobacteria;Alphaproteobacteria;Sphingomonadales;Erythrobacteraceae;Erythrobacter;
1	0	0	1	OSD189_6_14_YNG	Bacteria;Proteobacteria;Alphaproteobacteria;Sphingomonadales;Erythrobacteraceae;uncultured;
1	0	0	1	OSD189_6_14_YNG	Bacteria;Proteobacteria;Alphaproteobacteria;Sphingomonadales;Sphingomonadaceae;Parasphingopyxis;
1	1	1	3	OSD189_6_14_YNG	Bacteria;Proteobacteria;Alphaproteobacteria;Sphingomonadales;Sphingomonadaceae;Rhizorhapis;
2	0	0	2	OSD189_6_14_YNG	Bacteria;Proteobacteria;Alphaproteobacteria;Sphingomonadales;Sphingomonadaceae;Sphingobium;
14	22	16	52	OSD189_6_14_YNG	Bacteria;Proteobacteria;Betaproteobacteria;Burkholderiales;Alcaligenaceae;MWH-UniP1 aquatic group;
1	0	0	1	OSD189_6_14_YNG	Bacteria;Proteobacteria;Betaproteobacteria;Burkholderiales;Burkholderiaceae;Burkholderia-Paraburkholderia;
2	1	0	3	OSD189_6_14_YNG	Bacteria;Proteobacteria;Betaproteobacteria;Burkholderiales;Burkholderiaceae;Ralstonia;
1	0	0	1	OSD189_6_14_YNG	Bacteria;Proteobacteria;Betaproteobacteria;Burkholderiales;Oxalobacteraceae;Massilia;
7	10	3	20	OSD189_6_14_YNG	Bacteria;Proteobacteria;Betaproteobacteria;Hydrogenophilales;Hydrogenophilaceae;uncultured;
5	4	0	9	OSD189_6_14_YNG	Bacteria;Proteobacteria;Betaproteobacteria;Methylophilales;Methylophilaceae;OM43 clade;
1	0	0	1	OSD189_6_14_YNG	Bacteria;Proteobacteria;Betaproteobacteria;TRA3-20;
1	0	0	1	OSD189_6_14_YNG	Bacteria;Proteobacteria;Deltaproteobacteria;Bdellovibrionales;Bacteriovoracaceae;Halobacteriovorax;
1	0	0	1	OSD189_6_14_YNG	Bacteria;Proteobacteria;Deltaproteobacteria;Bdellovibrionales;Bacteriovoracaceae;Peredibacter;
7	10	13	30	OSD189_6_14_YNG	Bacteria;Proteobacteria;Deltaproteobacteria;Bdellovibrionales;Bacteriovoracaceae;uncultured;
26	20	17	63	OSD189_6_14_YNG	Bacteria;Proteobacteria;Deltaproteobacteria;Bdellovibrionales;Bdellovibrionaceae;OM27 clade;
14	7	2	23	OSD189_6_14_YNG	Bacteria;Proteobacteria;Deltaproteobacteria;Bradymonadales;
1	0	0	1	OSD189_6_14_YNG	Bacteria;Proteobacteria;Deltaproteobacteria;Desulfurellales;Desulfurellaceae;H16;
1	0	0	1	OSD189_6_14_YNG	Bacteria;Proteobacteria;Deltaproteobacteria;Desulfuromonadales;Desulfuromonadaceae;Pelobacter;
1	1	0	2	OSD189_6_14_YNG	Bacteria;Proteobacteria;Deltaproteobacteria;Myxococcales;BIrii41;
5	2	1	8	OSD189_6_14_YNG	Bacteria;Proteobacteria;Deltaproteobacteria;Myxococcales;Blfdi19;
1	0	0	1	OSD189_6_14_YNG	Bacteria;Proteobacteria;Deltaproteobacteria;Myxococcales;Nannocystaceae;
9	8	21	38	OSD189_6_14_YNG	Bacteria;Proteobacteria;Deltaproteobacteria;Myxococcales;P3OB-42;
1	0	0	1	OSD189_6_14_YNG	Bacteria;Proteobacteria;Deltaproteobacteria;NB1-j;
17	9	5	31	OSD189_6_14_YNG	Bacteria;Proteobacteria;Deltaproteobacteria;Oligoflexales;Oligoflexaceae;
61	116	166	343	OSD189_6_14_YNG	Bacteria;Proteobacteria;Deltaproteobacteria;SAR324 clade(Marine group B);
2	0	0	2	OSD189_6_14_YNG	Bacteria;Proteobacteria;Epsilonproteobacteria;Campylobacterales;Helicobacteraceae;Sulfurovum;
1	1	0	2	OSD189_6_14_YNG	Bacteria;Proteobacteria;Gammaproteobacteria;Alteromonadales;Alteromonadaceae;Alteromonas;
2	1	0	3	OSD189_6_14_YNG	Bacteria;Proteobacteria;Gammaproteobacteria;Alteromonadales;Alteromonadaceae;Marinobacter;
1	1	0	2	OSD189_6_14_YNG	Bacteria;Proteobacteria;Gammaproteobacteria;Alteromonadales;Alteromonadaceae;Paraglaciecola;
1	0	0	1	OSD189_6_14_YNG	Bacteria;Proteobacteria;Gammaproteobacteria;Alteromonadales;Alteromonadaceae;Salinimonas;
1	0	0	1	OSD189_6_14_YNG	Bacteria;Proteobacteria;Gammaproteobacteria;Alteromonadales;Alteromonadaceae;uncultured;
5	6	3	14	OSD189_6_14_YNG	Bacteria;Proteobacteria;Gammaproteobacteria;Alteromonadales;Idiomarinaceae;Idiomarina;
5	9	4	18	OSD189_6_14_YNG	Bacteria;Proteobacteria;Gammaproteobacteria;Alteromonadales;Pseudoalteromonadaceae;Pseudoalteromonas;
2	1	0	3	OSD189_6_14_YNG	Bacteria;Proteobacteria;Gammaproteobacteria;Alteromonadales;Pseudoalteromonadaceae;uncultured;
2	0	0	2	OSD189_6_14_YNG	Bacteria;Proteobacteria;Gammaproteobacteria;Alteromonadales;Psychromonadaceae;Psychromonas;
3	0	0	3	OSD189_6_14_YNG	Bacteria;Proteobacteria;Gammaproteobacteria;Alteromonadales;Shewanellaceae;Shewanella;
1	0	0	1	OSD189_6_14_YNG	Bacteria;Proteobacteria;Gammaproteobacteria;Arenicellales;Arenicellaceae;Arenicella;
1	0	0	1	OSD189_6_14_YNG	Bacteria;Proteobacteria;Gammaproteobacteria;Cellvibrionales;Cellvibrionaceae;Maricurvus;
1	0	0	1	OSD189_6_14_YNG	Bacteria;Proteobacteria;Gammaproteobacteria;Cellvibrionales;Halieaceae;
1	0	0	1	OSD189_6_14_YNG	Bacteria;Proteobacteria;Gammaproteobacteria;Cellvibrionales;Halieaceae;Haliea;
2	0	0	2	OSD189_6_14_YNG	Bacteria;Proteobacteria;Gammaproteobacteria;Cellvibrionales;Halieaceae;Halioglobus;
3	1	0	4	OSD189_6_14_YNG	Bacteria;Proteobacteria;Gammaproteobacteria;Cellvibrionales;Halieaceae;Luminiphilus;
41	75	63	179	OSD189_6_14_YNG	Bacteria;Proteobacteria;Gammaproteobacteria;Cellvibrionales;Halieaceae;OM60(NOR5) clade;
1	1	2	4	OSD189_6_14_YNG	Bacteria;Proteobacteria;Gammaproteobacteria;Cellvibrionales;Porticoccaceae;C1-B045;
3	4	3	10	OSD189_6_14_YNG	Bacteria;Proteobacteria;Gammaproteobacteria;Cellvibrionales;Porticoccaceae;SAR92 clade;
36	50	57	143	OSD189_6_14_YNG	Bacteria;Proteobacteria;Gammaproteobacteria;Cellvibrionales;Spongiibacteraceae;BD1-7 clade;
1	0	0	1	OSD189_6_14_YNG	Bacteria;Proteobacteria;Gammaproteobacteria;Chromatiales;Chromatiaceae;Rheinheimera;
1	0	0	1	OSD189_6_14_YNG	Bacteria;Proteobacteria;Gammaproteobacteria;Chromatiales;Ectothiorhodospiraceae;uncultured;
2	0	0	2	OSD189_6_14_YNG	Bacteria;Proteobacteria;Gammaproteobacteria;CS-B046;
5	3	3	11	OSD189_6_14_YNG	Bacteria;Proteobacteria;Gammaproteobacteria;E01-9C-26 marine group;
8	7	0	15	OSD189_6_14_YNG	Bacteria;Proteobacteria;Gammaproteobacteria;Enterobacteriales;Enterobacteriaceae;Citrobacter;
7	24	37	68	OSD189_6_14_YNG	Bacteria;Proteobacteria;Gammaproteobacteria;Enterobacteriales;Enterobacteriaceae;Enterobacter;
3	0	0	3	OSD189_6_14_YNG	Bacteria;Proteobacteria;Gammaproteobacteria;Enterobacteriales;Enterobacteriaceae;Escherichia-Shigella;
1	0	0	1	OSD189_6_14_YNG	Bacteria;Proteobacteria;Gammaproteobacteria;Enterobacteriales;Enterobacteriaceae;Klebsiella;
1	0	0	1	OSD189_6_14_YNG	Bacteria;Proteobacteria;Gammaproteobacteria;Enterobacteriales;Enterobacteriaceae;Lelliottia;
1	0	0	1	OSD189_6_14_YNG	Bacteria;Proteobacteria;Gammaproteobacteria;Enterobacteriales;Enterobacteriaceae;Plesiomonas;
1	0	0	1	OSD189_6_14_YNG	Bacteria;Proteobacteria;Gammaproteobacteria;Enterobacteriales;Enterobacteriaceae;Rahnella;
1	3	0	4	OSD189_6_14_YNG	Bacteria;Proteobacteria;Gammaproteobacteria;Enterobacteriales;Enterobacteriaceae;Raoultella;
9	13	15	37	OSD189_6_14_YNG	Bacteria;Proteobacteria;Gammaproteobacteria;Enterobacteriales;Enterobacteriaceae;Serratia;
1	0	0	1	OSD189_6_14_YNG	Bacteria;Proteobacteria;Gammaproteobacteria;Enterobacteriales;Enterobacteriaceae;Yersinia;
92	167	218	477	OSD189_6_14_YNG	Bacteria;Proteobacteria;Gammaproteobacteria;Gammaproteobacteria Incertae Sedis;Unknown Family;uncultured;
1	0	0	1	OSD189_6_14_YNG	Bacteria;Proteobacteria;Gammaproteobacteria;Gammaproteobacteria Incertae Sedis;Unknown Family;Wenzhouxiangella;
2	0	0	2	OSD189_6_14_YNG	Bacteria;Proteobacteria;Gammaproteobacteria;HTA4;
18	28	17	63	OSD189_6_14_YNG	Bacteria;Proteobacteria;Gammaproteobacteria;KI89A clade;
22	1	3	26	OSD189_6_14_YNG	Bacteria;Proteobacteria;Gammaproteobacteria;Legionellales;Coxiellaceae;Coxiella;
1	0	0	1	OSD189_6_14_YNG	Bacteria;Proteobacteria;Gammaproteobacteria;Methylococcales;Methylococcaceae;Methylovulum;
1	0	0	1	OSD189_6_14_YNG	Bacteria;Proteobacteria;Gammaproteobacteria;Oceanospirillales;2B4;
5	1	0	6	OSD189_6_14_YNG	Bacteria;Proteobacteria;Gammaproteobacteria;Oceanospirillales;Alcanivoracaceae;Alcanivorax;
1	0	0	1	OSD189_6_14_YNG	Bacteria;Proteobacteria;Gammaproteobacteria;Oceanospirillales;BPS-CK174;
2	0	0	2	OSD189_6_14_YNG	Bacteria;Proteobacteria;Gammaproteobacteria;Oceanospirillales;CrystalBog021C3;
1	0	0	1	OSD189_6_14_YNG	Bacteria;Proteobacteria;Gammaproteobacteria;Oceanospirillales;Hahellaceae;Endozoicomonas;
1	0	0	1	OSD189_6_14_YNG	Bacteria;Proteobacteria;Gammaproteobacteria;Oceanospirillales;Hahellaceae;Hahella;
1	0	0	1	OSD189_6_14_YNG	Bacteria;Proteobacteria;Gammaproteobacteria;Oceanospirillales;Halomonadaceae;Chromohalobacter;
2	0	0	2	OSD189_6_14_YNG	Bacteria;Proteobacteria;Gammaproteobacteria;Oceanospirillales;Halomonadaceae;Halomonas;
1	0	0	1	OSD189_6_14_YNG	Bacteria;Proteobacteria;Gammaproteobacteria;Oceanospirillales;Halomonadaceae;Salinicola;
1	0	0	1	OSD189_6_14_YNG	Bacteria;Proteobacteria;Gammaproteobacteria;Oceanospirillales;JL-ETNP-Y6;
4	3	1	8	OSD189_6_14_YNG	Bacteria;Proteobacteria;Gammaproteobacteria;Oceanospirillales;Litoricolaceae;Litoricola;
10	2	0	12	OSD189_6_14_YNG	Bacteria;Proteobacteria;Gammaproteobacteria;Oceanospirillales;Oceanospirillaceae;Marinobacterium;
19	16	17	52	OSD189_6_14_YNG	Bacteria;Proteobacteria;Gammaproteobacteria;Oceanospirillales;Oceanospirillaceae;Pseudohongiella;
19	21	19	59	OSD189_6_14_YNG	Bacteria;Proteobacteria;Gammaproteobacteria;Oceanospirillales;OM182 clade;
371	945	1217	2533	OSD189_6_14_YNG	Bacteria;Proteobacteria;Gammaproteobacteria;Oceanospirillales;SAR86 clade;
1	0	0	1	OSD189_6_14_YNG	Bacteria;Proteobacteria;Gammaproteobacteria;Oceanospirillales;TBZ33;
1	0	0	1	OSD189_6_14_YNG	Bacteria;Proteobacteria;Gammaproteobacteria;Pasteurellales;Pasteurellaceae;Actinobacillus;
3	1	1	5	OSD189_6_14_YNG	Bacteria;Proteobacteria;Gammaproteobacteria;Pseudomonadales;Pseudomonadaceae;Pseudomonas;
8	4	1	13	OSD189_6_14_YNG	Bacteria;Proteobacteria;Gammaproteobacteria;Salinisphaerales;Salinisphaeraceae;Salinisphaera;
5	10	8	23	OSD189_6_14_YNG	Bacteria;Proteobacteria;Gammaproteobacteria;Salinisphaerales;Salinisphaeraceae;ZD0417 marine group;
1	0	0	1	OSD189_6_14_YNG	Bacteria;Proteobacteria;Gammaproteobacteria;Thiotrichales;
1	0	0	1	OSD189_6_14_YNG	Bacteria;Proteobacteria;Gammaproteobacteria;Thiotrichales;EV818SWSAP88;
9	21	28	58	OSD189_6_14_YNG	Bacteria;Proteobacteria;Gammaproteobacteria;Thiotrichales;Thiotrichaceae;Thiothrix;
1	0	0	1	OSD189_6_14_YNG	Bacteria;Proteobacteria;Gammaproteobacteria;Thiotrichales;Thiotrichaceae;uncultured;
3	0	0	3	OSD189_6_14_YNG	Bacteria;Proteobacteria;Gammaproteobacteria;Thiotrichales;Thiotrichales Incertae Sedis;Caedibacter;
7	4	2	13	OSD189_6_14_YNG	Bacteria;Proteobacteria;Gammaproteobacteria;Thiotrichales;Thiotrichales Incertae Sedis;Candidatus Endoecteinascidia;
2	0	0	2	OSD189_6_14_YNG	Bacteria;Proteobacteria;Gammaproteobacteria;uncultured;
1	0	0	1	OSD189_6_14_YNG	Bacteria;Proteobacteria;Gammaproteobacteria;Vibrionales;Vibrionaceae;Enterovibrio;
2	2	0	4	OSD189_6_14_YNG	Bacteria;Proteobacteria;Gammaproteobacteria;Vibrionales;Vibrionaceae;Grimontia;
1	0	0	1	OSD189_6_14_YNG	Bacteria;Proteobacteria;Gammaproteobacteria;Vibrionales;Vibrionaceae;Photobacterium;
1	0	0	1	OSD189_6_14_YNG	Bacteria;Proteobacteria;Gammaproteobacteria;Vibrionales;Vibrionaceae;uncultured;
19	29	22	70	OSD189_6_14_YNG	Bacteria;Proteobacteria;Gammaproteobacteria;Vibrionales;Vibrionaceae;Vibrio;
13	12	13	38	OSD189_6_14_YNG	Bacteria;Proteobacteria;Gammaproteobacteria;Xanthomonadales;JTB255 marine benthic group;
4	3	2	9	OSD189_6_14_YNG	Bacteria;Proteobacteria;Gammaproteobacteria;Xanthomonadales;Xanthomonadaceae;Stenotrophomonas;
1	0	0	1	OSD189_6_14_YNG	Bacteria;Proteobacteria;JdFBHP3;
9	7	8	24	OSD189_6_14_YNG	Bacteria;Proteobacteria;SPOTSOCT00m83;
17	30	32	79	OSD189_6_14_YNG	Bacteria;SBR1093;
1	0	0	1	OSD189_6_14_YNG	Bacteria;Spirochaetae;Spirochaetes;Spirochaetales;Brevinemataceae;Brevinema;
10	10	9	29	OSD189_6_14_YNG	Bacteria;Verrucomicrobia;Arctic97B-4 marine group;
2	0	2	4	OSD189_6_14_YNG	Bacteria;Verrucomicrobia;OPB35 soil group;
2	1	0	3	OSD189_6_14_YNG	Bacteria;Verrucomicrobia;Opitutae;A714019;
11	8	7	26	OSD189_6_14_YNG	Bacteria;Verrucomicrobia;Opitutae;MB11C04 marine group;
2	0	0	2	OSD189_6_14_YNG	Bacteria;Verrucomicrobia;Opitutae;Puniceicoccales;Puniceicoccaceae;Cerasicoccus;
53	133	230	416	OSD189_6_14_YNG	Bacteria;Verrucomicrobia;Opitutae;Puniceicoccales;Puniceicoccaceae;Coraliomargarita;
1	1	0	2	OSD189_6_14_YNG	Bacteria;Verrucomicrobia;Opitutae;Puniceicoccales;Puniceicoccaceae;Lentimonas;
4	2	8	14	OSD189_6_14_YNG	Bacteria;Verrucomicrobia;Opitutae;Puniceicoccales;Puniceicoccaceae;marine group;
3	1	0	4	OSD189_6_14_YNG	Bacteria;Verrucomicrobia;Opitutae;Puniceicoccales;Puniceicoccaceae;Pelagicoccus;
26	52	75	153	OSD189_6_14_YNG	Bacteria;Verrucomicrobia;R76-B128;
5	8	9	22	OSD189_6_14_YNG	Bacteria;Verrucomicrobia;Verrucomicrobiae;Verrucomicrobiales;DEV007;
3	2	2	7	OSD189_6_14_YNG	Bacteria;Verrucomicrobia;Verrucomicrobiae;Verrucomicrobiales;Rubritaleaceae;Rubritalea;
159	114	141	414	OSD189_6_14_YNG	No Relative
1	0	0	1	OSD190_6_14_KI	Archaea;Bathyarchaeota;
125	591	1015	1731	OSD190_6_14_KI	Archaea;Euryarchaeota;Thermoplasmata;Thermoplasmatales;Marine Group II;
9	43	76	128	OSD190_6_14_KI	Archaea;Euryarchaeota;Thermoplasmata;Thermoplasmatales;Marine Group III;
1	0	0	1	OSD190_6_14_KI	Archaea;Thaumarchaeota;Marine Group I;
1	19	6	26	OSD190_6_14_KI	Archaea;Thaumarchaeota;Marine Group I;Unknown Order;Unknown Family;Candidatus Nitrosoarchaeum;
12	90	128	230	OSD190_6_14_KI	Archaea;Thaumarchaeota;Marine Group I;Unknown Order;Unknown Family;Candidatus Nitrosopelagicus;
28	103	292	423	OSD190_6_14_KI	Archaea;Thaumarchaeota;Marine Group I;Unknown Order;Unknown Family;Candidatus Nitrosopumilus;
1	0	0	1	OSD190_6_14_KI	Archaea;Woesearchaeota (DHVEG-6);
1	1	0	2	OSD190_6_14_KI	Bacteria;Acidobacteria;Subgroup 21;
2	0	0	2	OSD190_6_14_KI	Bacteria;Acidobacteria;Subgroup 22;
1	0	0	1	OSD190_6_14_KI	Bacteria;Acidobacteria;Subgroup 9;
1	0	0	1	OSD190_6_14_KI	Bacteria;Actinobacteria;Acidimicrobiia;Acidimicrobiales;Acidimicrobiaceae;uncultured;
96	193	380	669	OSD190_6_14_KI	Bacteria;Actinobacteria;Acidimicrobiia;Acidimicrobiales;OM1 clade;Candidatus Actinomarina;
45	97	105	247	OSD190_6_14_KI	Bacteria;Actinobacteria;Acidimicrobiia;Acidimicrobiales;Sva0996 marine group;
1	0	0	1	OSD190_6_14_KI	Bacteria;Actinobacteria;Acidimicrobiia;Acidimicrobiales;uncultured;
1	0	0	1	OSD190_6_14_KI	Bacteria;Actinobacteria;Nitriliruptoria;Euzebyales;Euzebyaceae;Euzebya;
1	0	0	1	OSD190_6_14_KI	Bacteria;Bacteroidetes;Bacteroidetes Incertae Sedis;Order II;Rhodothermaceae;uncultured;
3	0	0	3	OSD190_6_14_KI	Bacteria;Bacteroidetes;Bacteroidia;Bacteroidales;Prolixibacteraceae;Prolixibacter;
1	0	0	1	OSD190_6_14_KI	Bacteria;Bacteroidetes;Cytophagia;Cytophagales;Cytophagaceae;uncultured;
1	0	0	1	OSD190_6_14_KI	Bacteria;Bacteroidetes;Cytophagia;Cytophagales;Flammeovirgaceae;Aureibacter;
1	0	0	1	OSD190_6_14_KI	Bacteria;Bacteroidetes;Cytophagia;Cytophagales;Flammeovirgaceae;Flammeovirga;
5	12	8	25	OSD190_6_14_KI	Bacteria;Bacteroidetes;Cytophagia;Cytophagales;Flammeovirgaceae;Marinoscillum;
11	6	4	21	OSD190_6_14_KI	Bacteria;Bacteroidetes;Cytophagia;Cytophagales;Flammeovirgaceae;uncultured;
7	3	1	11	OSD190_6_14_KI	Bacteria;Bacteroidetes;Flavobacteriia;Flavobacteriales;Cryomorphaceae;Crocinitomix;
9	9	9	27	OSD190_6_14_KI	Bacteria;Bacteroidetes;Flavobacteriia;Flavobacteriales;Cryomorphaceae;Fluviicola;
8	5	0	13	OSD190_6_14_KI	Bacteria;Bacteroidetes;Flavobacteriia;Flavobacteriales;Cryomorphaceae;NS10 marine group;
1	0	0	1	OSD190_6_14_KI	Bacteria;Bacteroidetes;Flavobacteriia;Flavobacteriales;Cryomorphaceae;Owenweeksia;
98	278	381	757	OSD190_6_14_KI	Bacteria;Bacteroidetes;Flavobacteriia;Flavobacteriales;Cryomorphaceae;uncultured;
1	0	0	1	OSD190_6_14_KI	Bacteria;Bacteroidetes;Flavobacteriia;Flavobacteriales;Flavobacteriaceae;Algitalea;
3	0	0	3	OSD190_6_14_KI	Bacteria;Bacteroidetes;Flavobacteriia;Flavobacteriales;Flavobacteriaceae;Aquibacter;
2	0	0	2	OSD190_6_14_KI	Bacteria;Bacteroidetes;Flavobacteriia;Flavobacteriales;Flavobacteriaceae;Aquimarina;
2	1	1	4	OSD190_6_14_KI	Bacteria;Bacteroidetes;Flavobacteriia;Flavobacteriales;Flavobacteriaceae;Flavicella;
2	5	4	11	OSD190_6_14_KI	Bacteria;Bacteroidetes;Flavobacteriia;Flavobacteriales;Flavobacteriaceae;Formosa;
1	0	0	1	OSD190_6_14_KI	Bacteria;Bacteroidetes;Flavobacteriia;Flavobacteriales;Flavobacteriaceae;Jejudonia;
1	0	0	1	OSD190_6_14_KI	Bacteria;Bacteroidetes;Flavobacteriia;Flavobacteriales;Flavobacteriaceae;Lutimonas;
26	108	182	316	OSD190_6_14_KI	Bacteria;Bacteroidetes;Flavobacteriia;Flavobacteriales;Flavobacteriaceae;NS2b marine group;
45	97	87	229	OSD190_6_14_KI	Bacteria;Bacteroidetes;Flavobacteriia;Flavobacteriales;Flavobacteriaceae;NS4 marine group;
140	348	521	1009	OSD190_6_14_KI	Bacteria;Bacteroidetes;Flavobacteriia;Flavobacteriales;Flavobacteriaceae;NS5 marine group;
2	1	0	3	OSD190_6_14_KI	Bacteria;Bacteroidetes;Flavobacteriia;Flavobacteriales;Flavobacteriaceae;Olleya;
1	4	1	6	OSD190_6_14_KI	Bacteria;Bacteroidetes;Flavobacteriia;Flavobacteriales;Flavobacteriaceae;Polaribacter 4;
3	0	0	3	OSD190_6_14_KI	Bacteria;Bacteroidetes;Flavobacteriia;Flavobacteriales;Flavobacteriaceae;Pseudofulvibacter;
1	0	0	1	OSD190_6_14_KI	Bacteria;Bacteroidetes;Flavobacteriia;Flavobacteriales;Flavobacteriaceae;Psychroserpens;
1	0	0	1	OSD190_6_14_KI	Bacteria;Bacteroidetes;Flavobacteriia;Flavobacteriales;Flavobacteriaceae;Salegentibacter;
1	0	0	1	OSD190_6_14_KI	Bacteria;Bacteroidetes;Flavobacteriia;Flavobacteriales;Flavobacteriaceae;Spongiiferula;
3	3	0	6	OSD190_6_14_KI	Bacteria;Bacteroidetes;Flavobacteriia;Flavobacteriales;Flavobacteriaceae;Tenacibaculum;
1	1	0	2	OSD190_6_14_KI	Bacteria;Bacteroidetes;Flavobacteriia;Flavobacteriales;Flavobacteriaceae;Ulvibacter;
9	7	3	19	OSD190_6_14_KI	Bacteria;Bacteroidetes;Flavobacteriia;Flavobacteriales;Flavobacteriaceae;uncultured;
2	0	0	2	OSD190_6_14_KI	Bacteria;Bacteroidetes;Flavobacteriia;Flavobacteriales;Flavobacteriaceae;Winogradskyella;
9	12	16	37	OSD190_6_14_KI	Bacteria;Bacteroidetes;Flavobacteriia;Flavobacteriales;NS7 marine group;
138	312	425	875	OSD190_6_14_KI	Bacteria;Bacteroidetes;Flavobacteriia;Flavobacteriales;NS9 marine group;
1	0	0	1	OSD190_6_14_KI	Bacteria;Bacteroidetes;Sphingobacteriia;Sphingobacteriales;Chitinophagaceae;Taibaiella;
1	0	0	1	OSD190_6_14_KI	Bacteria;Bacteroidetes;Sphingobacteriia;Sphingobacteriales;S15-21;
2	0	0	2	OSD190_6_14_KI	Bacteria;Bacteroidetes;Sphingobacteriia;Sphingobacteriales;Saprospiraceae;Aureispira;
2	0	0	2	OSD190_6_14_KI	Bacteria;Bacteroidetes;Sphingobacteriia;Sphingobacteriales;Saprospiraceae;Lewinella;
1	0	0	1	OSD190_6_14_KI	Bacteria;Bacteroidetes;Sphingobacteriia;Sphingobacteriales;Saprospiraceae;Phaeodactylibacter;
2	0	0	2	OSD190_6_14_KI	Bacteria;Bacteroidetes;Sphingobacteriia;Sphingobacteriales;Saprospiraceae;Portibacter;
1	0	0	1	OSD190_6_14_KI	Bacteria;Bacteroidetes;Sphingobacteriia;Sphingobacteriales;Saprospiraceae;Rubidimonas;
18	4	3	25	OSD190_6_14_KI	Bacteria;Bacteroidetes;Sphingobacteriia;Sphingobacteriales;Saprospiraceae;uncultured;
3	0	0	3	OSD190_6_14_KI	Bacteria;Bacteroidetes;Sphingobacteriia;Sphingobacteriales;uncultured;
2	0	0	2	OSD190_6_14_KI	Bacteria;Bacteroidetes;WCHB1-32;
1	0	0	1	OSD190_6_14_KI	Bacteria;Chlamydiae;Chlamydiae;Chlamydiales;Simkaniaceae;Candidatus Fritschea;
1	0	0	1	OSD190_6_14_KI	Bacteria;Chlamydiae;Chlamydiae;Chlamydiales;Simkaniaceae;uncultured;
1	0	0	1	OSD190_6_14_KI	Bacteria;Chlorobi;Chlorobia;Chlorobiales;Chlorobiaceae;Chlorobium;
1	0	0	1	OSD190_6_14_KI	Bacteria;Chloroflexi;Anaerolineae;Anaerolineales;Anaerolineaceae;uncultured;
4	3	5	12	OSD190_6_14_KI	Bacteria;Chloroflexi;JG30-KF-CM66;
25	37	33	95	OSD190_6_14_KI	Bacteria;Chloroflexi;SAR202 clade;
490	1194	1594	3278	OSD190_6_14_KI	Bacteria;Cyanobacteria;Chloroplast;
49	58	36	143	OSD190_6_14_KI	Bacteria;Cyanobacteria;Cyanobacteria;SubsectionI;FamilyI;Prochlorococcus;
151	506	932	1589	OSD190_6_14_KI	Bacteria;Cyanobacteria;Cyanobacteria;SubsectionI;FamilyI;Synechococcus;
1	0	0	1	OSD190_6_14_KI	Bacteria;Cyanobacteria;Cyanobacteria;SubsectionIII;FamilyI;Phormidium;
1	0	0	1	OSD190_6_14_KI	Bacteria;Cyanobacteria;Melainabacteria;Vampirovibrionales;
7	3	0	10	OSD190_6_14_KI	Bacteria;Cyanobacteria;ML635J-21;
1	0	0	1	OSD190_6_14_KI	Bacteria;Elusimicrobia;Elusimicrobia;MVP-88;
1	0	0	1	OSD190_6_14_KI	Bacteria;Fibrobacteres;Fibrobacteria;Fibrobacterales;Fibrobacteraceae;uncultured;
2	0	0	2	OSD190_6_14_KI	Bacteria;Firmicutes;Bacilli;Bacillales;Bacillaceae;Oceanobacillus;
1	0	0	1	OSD190_6_14_KI	Bacteria;Firmicutes;Bacilli;Bacillales;Planococcaceae;Chungangia;
1	0	0	1	OSD190_6_14_KI	Bacteria;Firmicutes;Bacilli;Lactobacillales;Streptococcaceae;Streptococcus;
1	0	0	1	OSD190_6_14_KI	Bacteria;Firmicutes;Clostridia;Halanaerobiales;ODP1230B8.23;
1	0	0	1	OSD190_6_14_KI	Bacteria;Fusobacteria;Fusobacteriia;Fusobacteriales;Fusobacteriaceae;Propionigenium;
4	7	10	21	OSD190_6_14_KI	Bacteria;Gemmatimonadetes;BD2-11 terrestrial group;
1	2	1	4	OSD190_6_14_KI	Bacteria;Lentisphaerae;Lentisphaeria;Lentisphaerales;Lentisphaeraceae;Lentisphaera;
2	1	1	4	OSD190_6_14_KI	Bacteria;Lentisphaerae;Oligosphaeria;SS1-B-02-17;
209	472	817	1498	OSD190_6_14_KI	Bacteria;Marinimicrobia (SAR406 clade);
1	0	0	1	OSD190_6_14_KI	Bacteria;Nitrospinae;Nitrospinia;Nitrospinales;Nitrospinaceae;Nitrospina;
1	3	0	4	OSD190_6_14_KI	Bacteria;Nitrospinae;Nitrospinia;Nitrospinales;Nitrospinaceae;uncultured;
2	0	0	2	OSD190_6_14_KI	Bacteria;Omnitrophica;Omnitrophica Incertae Sedis;Unknown Order;Unknown Family;Candidatus Omnitrophus;
1	0	0	1	OSD190_6_14_KI	Bacteria;Parcubacteria;Candidatus Campbellbacteria;
2	3	2	7	OSD190_6_14_KI	Bacteria;PAUC34f;
1	0	0	1	OSD190_6_14_KI	Bacteria;Planctomycetes;BD7-11;
15	27	31	73	OSD190_6_14_KI	Bacteria;Planctomycetes;OM190;
23	32	14	69	OSD190_6_14_KI	Bacteria;Planctomycetes;Phycisphaerae;Phycisphaerales;Phycisphaeraceae;CL500-3;
4	7	5	16	OSD190_6_14_KI	Bacteria;Planctomycetes;Phycisphaerae;Phycisphaerales;Phycisphaeraceae;FS140-16B-02 marine group;
1	0	0	1	OSD190_6_14_KI	Bacteria;Planctomycetes;Phycisphaerae;Phycisphaerales;Phycisphaeraceae;JL-ETNP-F27;
4	5	7	16	OSD190_6_14_KI	Bacteria;Planctomycetes;Phycisphaerae;Phycisphaerales;Phycisphaeraceae;Urania-1B-19 marine sediment group;
1	0	0	1	OSD190_6_14_KI	Bacteria;Planctomycetes;Pla3 lineage;
1	0	0	1	OSD190_6_14_KI	Bacteria;Planctomycetes;Planctomycetacia;Brocadiales;Brocadiaceae;Candidatus Scalindua;
2	3	1	6	OSD190_6_14_KI	Bacteria;Planctomycetes;Planctomycetacia;Planctomycetales;Planctomycetaceae;Blastopirellula;
1	0	0	1	OSD190_6_14_KI	Bacteria;Planctomycetes;Planctomycetacia;Planctomycetales;Planctomycetaceae;Planctomyces;
2	0	0	2	OSD190_6_14_KI	Bacteria;Planctomycetes;Planctomycetacia;Planctomycetales;Planctomycetaceae;Rhodopirellula;
1	3	1	5	OSD190_6_14_KI	Bacteria;Planctomycetes;Planctomycetacia;Planctomycetales;Planctomycetaceae;Rubripirellula;
1	0	0	1	OSD190_6_14_KI	Bacteria;Planctomycetes;Planctomycetacia;Planctomycetales;Planctomycetaceae;uncultured;
1	0	0	1	OSD190_6_14_KI	Bacteria;Poribacteria;
3	0	1	4	OSD190_6_14_KI	Bacteria;Proteobacteria;AEGEAN-245;
1	0	0	1	OSD190_6_14_KI	Bacteria;Proteobacteria;Alphaproteobacteria;Alphaproteobacteria Incertae Sedis;uncultured;
4	0	0	4	OSD190_6_14_KI	Bacteria;Proteobacteria;Alphaproteobacteria;Caulobacterales;Caulobacteraceae;Brevundimonas;
1	0	0	1	OSD190_6_14_KI	Bacteria;Proteobacteria;Alphaproteobacteria;Caulobacterales;Caulobacteraceae;Caulobacter;
1	0	0	1	OSD190_6_14_KI	Bacteria;Proteobacteria;Alphaproteobacteria;Caulobacterales;Hyphomonadaceae;Litorimonas;
1	0	0	1	OSD190_6_14_KI	Bacteria;Proteobacteria;Alphaproteobacteria;Parvularculales;Parvularculaceae;
1	2	1	4	OSD190_6_14_KI	Bacteria;Proteobacteria;Alphaproteobacteria;Rhizobiales;Bradyrhizobiaceae;Bradyrhizobium;
5	8	5	18	OSD190_6_14_KI	Bacteria;Proteobacteria;Alphaproteobacteria;Rhizobiales;OCS116 clade;
2	0	0	2	OSD190_6_14_KI	Bacteria;Proteobacteria;Alphaproteobacteria;Rhizobiales;Phyllobacteriaceae;Pseudahrensia;
2	0	0	2	OSD190_6_14_KI	Bacteria;Proteobacteria;Alphaproteobacteria;Rhizobiales;Phyllobacteriaceae;uncultured;
63	166	271	500	OSD190_6_14_KI	Bacteria;Proteobacteria;Alphaproteobacteria;Rhizobiales;PS1 clade;
1	0	0	1	OSD190_6_14_KI	Bacteria;Proteobacteria;Alphaproteobacteria;Rhizobiales;uncultured;
1	1	0	2	OSD190_6_14_KI	Bacteria;Proteobacteria;Alphaproteobacteria;Rhodobacterales;Rhodobacteraceae;
1	0	0	1	OSD190_6_14_KI	Bacteria;Proteobacteria;Alphaproteobacteria;Rhodobacterales;Rhodobacteraceae;Actibacterium;
8	14	1	23	OSD190_6_14_KI	Bacteria;Proteobacteria;Alphaproteobacteria;Rhodobacterales;Rhodobacteraceae;Ascidiaceihabitans;
1	1	0	2	OSD190_6_14_KI	Bacteria;Proteobacteria;Alphaproteobacteria;Rhodobacterales;Rhodobacteraceae;Donghicola;
6	0	0	6	OSD190_6_14_KI	Bacteria;Proteobacteria;Alphaproteobacteria;Rhodobacterales;Rhodobacteraceae;Jannaschia;
4	9	18	31	OSD190_6_14_KI	Bacteria;Proteobacteria;Alphaproteobacteria;Rhodobacterales;Rhodobacteraceae;Lentibacter;
1	0	0	1	OSD190_6_14_KI	Bacteria;Proteobacteria;Alphaproteobacteria;Rhodobacterales;Rhodobacteraceae;Lutimaribacter;
1	0	0	1	OSD190_6_14_KI	Bacteria;Proteobacteria;Alphaproteobacteria;Rhodobacterales;Rhodobacteraceae;Maritimibacter;
1	0	0	1	OSD190_6_14_KI	Bacteria;Proteobacteria;Alphaproteobacteria;Rhodobacterales;Rhodobacteraceae;Oceaniovalibus;
1	0	0	1	OSD190_6_14_KI	Bacteria;Proteobacteria;Alphaproteobacteria;Rhodobacterales;Rhodobacteraceae;Octadecabacter;
3	6	29	38	OSD190_6_14_KI	Bacteria;Proteobacteria;Alphaproteobacteria;Rhodobacterales;Rhodobacteraceae;Planktomarina;
1	0	0	1	OSD190_6_14_KI	Bacteria;Proteobacteria;Alphaproteobacteria;Rhodobacterales;Rhodobacteraceae;Roseibacterium;
2	0	0	2	OSD190_6_14_KI	Bacteria;Proteobacteria;Alphaproteobacteria;Rhodobacterales;Rhodobacteraceae;Roseobacter clade NAC11-7 lineage;
2	0	0	2	OSD190_6_14_KI	Bacteria;Proteobacteria;Alphaproteobacteria;Rhodobacterales;Rhodobacteraceae;Roseovarius;
2	1	0	3	OSD190_6_14_KI	Bacteria;Proteobacteria;Alphaproteobacteria;Rhodobacterales;Rhodobacteraceae;Ruegeria;
2	9	1	12	OSD190_6_14_KI	Bacteria;Proteobacteria;Alphaproteobacteria;Rhodobacterales;Rhodobacteraceae;Sediminimonas;
1	0	0	1	OSD190_6_14_KI	Bacteria;Proteobacteria;Alphaproteobacteria;Rhodobacterales;Rhodobacteraceae;Shimia;
2	0	0	2	OSD190_6_14_KI	Bacteria;Proteobacteria;Alphaproteobacteria;Rhodobacterales;Rhodobacteraceae;Sulfitobacter;
1	0	0	1	OSD190_6_14_KI	Bacteria;Proteobacteria;Alphaproteobacteria;Rhodobacterales;Rhodobacteraceae;Thalassobius;
154	183	276	613	OSD190_6_14_KI	Bacteria;Proteobacteria;Alphaproteobacteria;Rhodobacterales;Rhodobacteraceae;uncultured;
1	0	0	1	OSD190_6_14_KI	Bacteria;Proteobacteria;Alphaproteobacteria;Rhodospirillales;Acetobacteraceae;Roseomonas;
6	6	4	16	OSD190_6_14_KI	Bacteria;Proteobacteria;Alphaproteobacteria;Rhodospirillales;AT-s3-44;
93	227	309	629	OSD190_6_14_KI	Bacteria;Proteobacteria;Alphaproteobacteria;Rhodospirillales;Rhodospirillaceae;AEGEAN-169 marine group;
3	2	0	5	OSD190_6_14_KI	Bacteria;Proteobacteria;Alphaproteobacteria;Rhodospirillales;Rhodospirillaceae;Magnetospira;
35	71	92	198	OSD190_6_14_KI	Bacteria;Proteobacteria;Alphaproteobacteria;Rhodospirillales;Rhodospirillaceae;OM75 clade;
77	104	79	260	OSD190_6_14_KI	Bacteria;Proteobacteria;Alphaproteobacteria;Rhodospirillales;Rhodospirillaceae;uncultured;
1	0	0	1	OSD190_6_14_KI	Bacteria;Proteobacteria;Alphaproteobacteria;Rickettsiales;EF100-94H03;
1	0	0	1	OSD190_6_14_KI	Bacteria;Proteobacteria;Alphaproteobacteria;Rickettsiales;Holosporaceae;uncultured;
3	0	0	3	OSD190_6_14_KI	Bacteria;Proteobacteria;Alphaproteobacteria;Rickettsiales;LWSR-14;
1	0	0	1	OSD190_6_14_KI	Bacteria;Proteobacteria;Alphaproteobacteria;Rickettsiales;MD3-55;
26	50	52	128	OSD190_6_14_KI	Bacteria;Proteobacteria;Alphaproteobacteria;Rickettsiales;Mitochondria;
3	0	0	3	OSD190_6_14_KI	Bacteria;Proteobacteria;Alphaproteobacteria;Rickettsiales;Rickettsiaceae;uncultured;
1	0	0	1	OSD190_6_14_KI	Bacteria;Proteobacteria;Alphaproteobacteria;Rickettsiales;Rickettsiales Incertae Sedis;Candidatus Hepatincola;
27	42	42	111	OSD190_6_14_KI	Bacteria;Proteobacteria;Alphaproteobacteria;Rickettsiales;S25-593;
145	386	428	959	OSD190_6_14_KI	Bacteria;Proteobacteria;Alphaproteobacteria;Rickettsiales;SAR116 clade;
3	4	0	7	OSD190_6_14_KI	Bacteria;Proteobacteria;Alphaproteobacteria;Rickettsiales;SAR116 clade;Candidatus Puniceispirillum;
2	0	0	2	OSD190_6_14_KI	Bacteria;Proteobacteria;Alphaproteobacteria;Rickettsiales;SHWN-night2;
4	6	0	10	OSD190_6_14_KI	Bacteria;Proteobacteria;Alphaproteobacteria;SAR11 clade;
1	0	0	1	OSD190_6_14_KI	Bacteria;Proteobacteria;Alphaproteobacteria;SAR11 clade;Chesapeake-Delaware Bay;
2	1	0	3	OSD190_6_14_KI	Bacteria;Proteobacteria;Alphaproteobacteria;SAR11 clade;Deep 1;
25	91	87	203	OSD190_6_14_KI	Bacteria;Proteobacteria;Alphaproteobacteria;SAR11 clade;Surface 1;
1	0	0	1	OSD190_6_14_KI	Bacteria;Proteobacteria;Alphaproteobacteria;SAR11 clade;Surface 1;Candidatus Pelagibacter;
6	13	15	34	OSD190_6_14_KI	Bacteria;Proteobacteria;Alphaproteobacteria;SAR11 clade;Surface 2;
1	2	2	5	OSD190_6_14_KI	Bacteria;Proteobacteria;Alphaproteobacteria;SAR11 clade;Surface 3;
26	54	55	135	OSD190_6_14_KI	Bacteria;Proteobacteria;Alphaproteobacteria;SAR11 clade;Surface 4;
1	0	0	1	OSD190_6_14_KI	Bacteria;Proteobacteria;Alphaproteobacteria;Sphingomonadales;Erythrobacteraceae;Altererythrobacter;
4	4	4	12	OSD190_6_14_KI	Bacteria;Proteobacteria;Alphaproteobacteria;Sphingomonadales;Erythrobacteraceae;Erythrobacter;
2	1	0	3	OSD190_6_14_KI	Bacteria;Proteobacteria;Alphaproteobacteria;Sphingomonadales;Sphingomonadaceae;Blastomonas;
1	0	0	1	OSD190_6_14_KI	Bacteria;Proteobacteria;Alphaproteobacteria;Sphingomonadales;Sphingomonadaceae;Novosphingobium;
3	0	0	3	OSD190_6_14_KI	Bacteria;Proteobacteria;Alphaproteobacteria;Sphingomonadales;Sphingomonadaceae;Sphingomonas;
3	2	2	7	OSD190_6_14_KI	Bacteria;Proteobacteria;Alphaproteobacteria;Sphingomonadales;Sphingomonadaceae;Sphingopyxis;
2	0	0	2	OSD190_6_14_KI	Bacteria;Proteobacteria;Alphaproteobacteria;Sphingomonadales;Sphingomonadaceae;Sphingorhabdus;
1	3	0	4	OSD190_6_14_KI	Bacteria;Proteobacteria;ARKICE-90;
4	1	1	6	OSD190_6_14_KI	Bacteria;Proteobacteria;Betaproteobacteria;Burkholderiales;Alcaligenaceae;MWH-UniP1 aquatic group;
4	11	9	24	OSD190_6_14_KI	Bacteria;Proteobacteria;Betaproteobacteria;Burkholderiales;Burkholderiaceae;Limnobacter;
1	0	3	4	OSD190_6_14_KI	Bacteria;Proteobacteria;Betaproteobacteria;Burkholderiales;Burkholderiaceae;Ralstonia;
1	0	0	1	OSD190_6_14_KI	Bacteria;Proteobacteria;Betaproteobacteria;Burkholderiales;Comamonadaceae;Aquabacterium;
3	2	0	5	OSD190_6_14_KI	Bacteria;Proteobacteria;Betaproteobacteria;Burkholderiales;Comamonadaceae;Hydrogenophaga;
1	1	0	2	OSD190_6_14_KI	Bacteria;Proteobacteria;Betaproteobacteria;Burkholderiales;Comamonadaceae;Variovorax;
1	0	0	1	OSD190_6_14_KI	Bacteria;Proteobacteria;Betaproteobacteria;Burkholderiales;Oxalobacteraceae;Collimonas;
1	0	0	1	OSD190_6_14_KI	Bacteria;Proteobacteria;Betaproteobacteria;Burkholderiales;Oxalobacteraceae;Massilia;
2	1	1	4	OSD190_6_14_KI	Bacteria;Proteobacteria;Betaproteobacteria;Hydrogenophilales;Hydrogenophilaceae;uncultured;
1	0	0	1	OSD190_6_14_KI	Bacteria;Proteobacteria;Betaproteobacteria;Methylophilales;Methylophilaceae;Methylotenera;
23	29	33	85	OSD190_6_14_KI	Bacteria;Proteobacteria;Betaproteobacteria;Methylophilales;Methylophilaceae;OM43 clade;
3	0	1	4	OSD190_6_14_KI	Bacteria;Proteobacteria;Deltaproteobacteria;Bdellovibrionales;Bacteriovoracaceae;Halobacteriovorax;
1	1	0	2	OSD190_6_14_KI	Bacteria;Proteobacteria;Deltaproteobacteria;Bdellovibrionales;Bacteriovoracaceae;uncultured;
37	18	18	73	OSD190_6_14_KI	Bacteria;Proteobacteria;Deltaproteobacteria;Bdellovibrionales;Bdellovibrionaceae;OM27 clade;
21	16	9	46	OSD190_6_14_KI	Bacteria;Proteobacteria;Deltaproteobacteria;Bradymonadales;
1	0	0	1	OSD190_6_14_KI	Bacteria;Proteobacteria;Deltaproteobacteria;Desulfobacterales;Desulfobacteraceae;Sva0081 sediment group;
1	0	0	1	OSD190_6_14_KI	Bacteria;Proteobacteria;Deltaproteobacteria;Desulfobacterales;Desulfobulbaceae;Desulforhopalus;
1	0	0	1	OSD190_6_14_KI	Bacteria;Proteobacteria;Deltaproteobacteria;Desulfovibrionales;Desulfovibrionaceae;Desulfovibrio;
3	8	8	19	OSD190_6_14_KI	Bacteria;Proteobacteria;Deltaproteobacteria;Desulfurellales;Desulfurellaceae;H16;
2	5	6	13	OSD190_6_14_KI	Bacteria;Proteobacteria;Deltaproteobacteria;Desulfuromonadales;Geobacteraceae;Geoalkalibacter;
1	0	0	1	OSD190_6_14_KI	Bacteria;Proteobacteria;Deltaproteobacteria;Myxococcales;bacteriap25;
2	1	0	3	OSD190_6_14_KI	Bacteria;Proteobacteria;Deltaproteobacteria;Myxococcales;BIrii41;
8	4	4	16	OSD190_6_14_KI	Bacteria;Proteobacteria;Deltaproteobacteria;Myxococcales;Blfdi19;
4	3	0	7	OSD190_6_14_KI	Bacteria;Proteobacteria;Deltaproteobacteria;Myxococcales;Eel-36e1D6;
7	8	9	24	OSD190_6_14_KI	Bacteria;Proteobacteria;Deltaproteobacteria;Myxococcales;P3OB-42;
5	2	2	9	OSD190_6_14_KI	Bacteria;Proteobacteria;Deltaproteobacteria;Myxococcales;Sandaracinaceae;uncultured;
16	10	20	46	OSD190_6_14_KI	Bacteria;Proteobacteria;Deltaproteobacteria;NB1-j;
19	26	30	75	OSD190_6_14_KI	Bacteria;Proteobacteria;Deltaproteobacteria;Oligoflexales;Oligoflexaceae;
29	48	43	120	OSD190_6_14_KI	Bacteria;Proteobacteria;Deltaproteobacteria;SAR324 clade(Marine group B);
3	1	1	5	OSD190_6_14_KI	Bacteria;Proteobacteria;Epsilonproteobacteria;Campylobacterales;Campylobacteraceae;Arcobacter;
2	0	0	2	OSD190_6_14_KI	Bacteria;Proteobacteria;Gammaproteobacteria;Aeromonadales;Aeromonadaceae;uncultured;
2	0	0	2	OSD190_6_14_KI	Bacteria;Proteobacteria;Gammaproteobacteria;Alteromonadales;Alteromonadaceae;
1	0	0	1	OSD190_6_14_KI	Bacteria;Proteobacteria;Gammaproteobacteria;Alteromonadales;Alteromonadaceae;Alteromonas;
4	1	0	5	OSD190_6_14_KI	Bacteria;Proteobacteria;Gammaproteobacteria;Alteromonadales;Alteromonadaceae;Marinobacter;
3	1	0	4	OSD190_6_14_KI	Bacteria;Proteobacteria;Gammaproteobacteria;Alteromonadales;Alteromonadaceae;Paraglaciecola;
1	0	0	1	OSD190_6_14_KI	Bacteria;Proteobacteria;Gammaproteobacteria;Alteromonadales;Alteromonadaceae;uncultured;
1	0	0	1	OSD190_6_14_KI	Bacteria;Proteobacteria;Gammaproteobacteria;Alteromonadales;Colwelliaceae;Colwellia;
2	1	1	4	OSD190_6_14_KI	Bacteria;Proteobacteria;Gammaproteobacteria;Alteromonadales;Colwelliaceae;Thalassotalea;
1	0	0	1	OSD190_6_14_KI	Bacteria;Proteobacteria;Gammaproteobacteria;Alteromonadales;Ferrimonadaceae;Ferrimonas;
6	4	0	10	OSD190_6_14_KI	Bacteria;Proteobacteria;Gammaproteobacteria;Alteromonadales;Idiomarinaceae;Idiomarina;
8	14	7	29	OSD190_6_14_KI	Bacteria;Proteobacteria;Gammaproteobacteria;Alteromonadales;Pseudoalteromonadaceae;Pseudoalteromonas;
2	4	1	7	OSD190_6_14_KI	Bacteria;Proteobacteria;Gammaproteobacteria;Alteromonadales;Psychromonadaceae;Psychromonas;
1	1	0	2	OSD190_6_14_KI	Bacteria;Proteobacteria;Gammaproteobacteria;Alteromonadales;Shewanellaceae;Shewanella;
3	0	0	3	OSD190_6_14_KI	Bacteria;Proteobacteria;Gammaproteobacteria;Arenicellales;Arenicellaceae;uncultured;
2	0	0	2	OSD190_6_14_KI	Bacteria;Proteobacteria;Gammaproteobacteria;BD7-8 marine group;
2	0	0	2	OSD190_6_14_KI	Bacteria;Proteobacteria;Gammaproteobacteria;Cellvibrionales;Cellvibrionaceae;Candidatus Endobugula;
1	0	0	1	OSD190_6_14_KI	Bacteria;Proteobacteria;Gammaproteobacteria;Cellvibrionales;Cellvibrionaceae;Maricurvus;
4	0	0	4	OSD190_6_14_KI	Bacteria;Proteobacteria;Gammaproteobacteria;Cellvibrionales;Cellvibrionaceae;uncultured;
3	1	3	7	OSD190_6_14_KI	Bacteria;Proteobacteria;Gammaproteobacteria;Cellvibrionales;Halieaceae;Haliea;
1	0	0	1	OSD190_6_14_KI	Bacteria;Proteobacteria;Gammaproteobacteria;Cellvibrionales;Halieaceae;Halioglobus;
27	38	26	91	OSD190_6_14_KI	Bacteria;Proteobacteria;Gammaproteobacteria;Cellvibrionales;Halieaceae;OM60(NOR5) clade;
2	9	8	19	OSD190_6_14_KI	Bacteria;Proteobacteria;Gammaproteobacteria;Cellvibrionales;Halieaceae;Parahaliea;
15	17	14	46	OSD190_6_14_KI	Bacteria;Proteobacteria;Gammaproteobacteria;Cellvibrionales;Porticoccaceae;SAR92 clade;
3	0	0	3	OSD190_6_14_KI	Bacteria;Proteobacteria;Gammaproteobacteria;Cellvibrionales;Spongiibacteraceae;BD1-7 clade;
1	0	0	1	OSD190_6_14_KI	Bacteria;Proteobacteria;Gammaproteobacteria;Cellvibrionales;Spongiibacteraceae;Dasania;
1	0	0	1	OSD190_6_14_KI	Bacteria;Proteobacteria;Gammaproteobacteria;Cellvibrionales;Spongiibacteraceae;Oceanicoccus;
1	2	0	3	OSD190_6_14_KI	Bacteria;Proteobacteria;Gammaproteobacteria;Chromatiales;Chromatiaceae;Rheinheimera;
1	0	0	1	OSD190_6_14_KI	Bacteria;Proteobacteria;Gammaproteobacteria;Chromatiales;Granulosicoccaceae;Granulosicoccus;
12	14	19	45	OSD190_6_14_KI	Bacteria;Proteobacteria;Gammaproteobacteria;E01-9C-26 marine group;
9	2	0	11	OSD190_6_14_KI	Bacteria;Proteobacteria;Gammaproteobacteria;Enterobacteriales;Enterobacteriaceae;Citrobacter;
6	46	74	126	OSD190_6_14_KI	Bacteria;Proteobacteria;Gammaproteobacteria;Enterobacteriales;Enterobacteriaceae;Enterobacter;
2	0	0	2	OSD190_6_14_KI	Bacteria;Proteobacteria;Gammaproteobacteria;Enterobacteriales;Enterobacteriaceae;Escherichia-Shigella;
1	0	0	1	OSD190_6_14_KI	Bacteria;Proteobacteria;Gammaproteobacteria;Enterobacteriales;Enterobacteriaceae;Plesiomonas;
1	0	0	1	OSD190_6_14_KI	Bacteria;Proteobacteria;Gammaproteobacteria;Enterobacteriales;Enterobacteriaceae;Rahnella;
1	3	0	4	OSD190_6_14_KI	Bacteria;Proteobacteria;Gammaproteobacteria;Enterobacteriales;Enterobacteriaceae;Raoultella;
6	12	22	40	OSD190_6_14_KI	Bacteria;Proteobacteria;Gammaproteobacteria;Enterobacteriales;Enterobacteriaceae;Serratia;
2	1	0	3	OSD190_6_14_KI	Bacteria;Proteobacteria;Gammaproteobacteria;Gammaproteobacteria Incertae Sedis;Unknown Family;Marinicella;
1	0	0	1	OSD190_6_14_KI	Bacteria;Proteobacteria;Gammaproteobacteria;Gammaproteobacteria Incertae Sedis;Unknown Family;Thiohalomonas;
17	23	31	71	OSD190_6_14_KI	Bacteria;Proteobacteria;Gammaproteobacteria;Gammaproteobacteria Incertae Sedis;Unknown Family;uncultured;
4	0	1	5	OSD190_6_14_KI	Bacteria;Proteobacteria;Gammaproteobacteria;HTA4;
28	26	19	73	OSD190_6_14_KI	Bacteria;Proteobacteria;Gammaproteobacteria;KI89A clade;
15	1	2	18	OSD190_6_14_KI	Bacteria;Proteobacteria;Gammaproteobacteria;Legionellales;Coxiellaceae;Coxiella;
1	0	0	1	OSD190_6_14_KI	Bacteria;Proteobacteria;Gammaproteobacteria;Oceanospirillales;
11	14	17	42	OSD190_6_14_KI	Bacteria;Proteobacteria;Gammaproteobacteria;Oceanospirillales;Alcanivoracaceae;Alcanivorax;
3	2	0	5	OSD190_6_14_KI	Bacteria;Proteobacteria;Gammaproteobacteria;Oceanospirillales;Hahellaceae;Endozoicomonas;
25	61	61	147	OSD190_6_14_KI	Bacteria;Proteobacteria;Gammaproteobacteria;Oceanospirillales;Halomonadaceae;Halomonas;
12	54	88	154	OSD190_6_14_KI	Bacteria;Proteobacteria;Gammaproteobacteria;Oceanospirillales;J8P41000-1F04;
9	0	0	9	OSD190_6_14_KI	Bacteria;Proteobacteria;Gammaproteobacteria;Oceanospirillales;JL-ETNP-Y6;
2	1	1	4	OSD190_6_14_KI	Bacteria;Proteobacteria;Gammaproteobacteria;Oceanospirillales;Litoricolaceae;Litoricola;
7	0	0	7	OSD190_6_14_KI	Bacteria;Proteobacteria;Gammaproteobacteria;Oceanospirillales;Oceanospirillaceae;Balneatrix;
6	5	0	11	OSD190_6_14_KI	Bacteria;Proteobacteria;Gammaproteobacteria;Oceanospirillales;Oceanospirillaceae;Marinobacterium;
23	50	43	116	OSD190_6_14_KI	Bacteria;Proteobacteria;Gammaproteobacteria;Oceanospirillales;Oceanospirillaceae;Pseudohongiella;
7	11	12	30	OSD190_6_14_KI	Bacteria;Proteobacteria;Gammaproteobacteria;Oceanospirillales;OM182 clade;
231	631	975	1837	OSD190_6_14_KI	Bacteria;Proteobacteria;Gammaproteobacteria;Oceanospirillales;SAR86 clade;
1	0	0	1	OSD190_6_14_KI	Bacteria;Proteobacteria;Gammaproteobacteria;Oceanospirillales;SS1-B-06-26;
1	0	0	1	OSD190_6_14_KI	Bacteria;Proteobacteria;Gammaproteobacteria;Oceanospirillales;SUP05 cluster;
16	11	4	31	OSD190_6_14_KI	Bacteria;Proteobacteria;Gammaproteobacteria;Oceanospirillales;ZD0405;
1	0	0	1	OSD190_6_14_KI	Bacteria;Proteobacteria;Gammaproteobacteria;Pseudomonadales;Moraxellaceae;Acinetobacter;
1	0	0	1	OSD190_6_14_KI	Bacteria;Proteobacteria;Gammaproteobacteria;Pseudomonadales;Moraxellaceae;Psychrobacter;
8	4	4	16	OSD190_6_14_KI	Bacteria;Proteobacteria;Gammaproteobacteria;Pseudomonadales;Pseudomonadaceae;Pseudomonas;
1	0	0	1	OSD190_6_14_KI	Bacteria;Proteobacteria;Gammaproteobacteria;PYR10d3;
1	0	0	1	OSD190_6_14_KI	Bacteria;Proteobacteria;Gammaproteobacteria;Salinisphaerales;Salinisphaeraceae;Oceanococcus;
8	16	18	42	OSD190_6_14_KI	Bacteria;Proteobacteria;Gammaproteobacteria;Salinisphaerales;Salinisphaeraceae;Salinisphaera;
34	38	59	131	OSD190_6_14_KI	Bacteria;Proteobacteria;Gammaproteobacteria;Salinisphaerales;Salinisphaeraceae;ZD0417 marine group;
1	1	0	2	OSD190_6_14_KI	Bacteria;Proteobacteria;Gammaproteobacteria;Sva0071;
1	1	0	2	OSD190_6_14_KI	Bacteria;Proteobacteria;Gammaproteobacteria;Thiotrichales;EV818SWSAP88;
1	0	0	1	OSD190_6_14_KI	Bacteria;Proteobacteria;Gammaproteobacteria;Thiotrichales;Francisellaceae;Francisella;
1	0	0	1	OSD190_6_14_KI	Bacteria;Proteobacteria;Gammaproteobacteria;Thiotrichales;Piscirickettsiaceae;uncultured;
1	0	0	1	OSD190_6_14_KI	Bacteria;Proteobacteria;Gammaproteobacteria;Thiotrichales;Thiotrichaceae;Cocleimonas;
1	2	0	3	OSD190_6_14_KI	Bacteria;Proteobacteria;Gammaproteobacteria;Thiotrichales;Thiotrichaceae;Leucothrix;
3	4	1	8	OSD190_6_14_KI	Bacteria;Proteobacteria;Gammaproteobacteria;Thiotrichales;Thiotrichaceae;Thiothrix;
1	0	0	1	OSD190_6_14_KI	Bacteria;Proteobacteria;Gammaproteobacteria;Thiotrichales;Thiotrichaceae;uncultured;
1	0	0	1	OSD190_6_14_KI	Bacteria;Proteobacteria;Gammaproteobacteria;Thiotrichales;Thiotrichales Incertae Sedis;Caedibacter;
6	4	1	11	OSD190_6_14_KI	Bacteria;Proteobacteria;Gammaproteobacteria;Thiotrichales;Thiotrichales Incertae Sedis;Candidatus Endoecteinascidia;
7	5	2	14	OSD190_6_14_KI	Bacteria;Proteobacteria;Gammaproteobacteria;uncultured;
1	0	0	1	OSD190_6_14_KI	Bacteria;Proteobacteria;Gammaproteobacteria;Vibrionales;Vibrionaceae;Enterovibrio;
2	0	0	2	OSD190_6_14_KI	Bacteria;Proteobacteria;Gammaproteobacteria;Vibrionales;Vibrionaceae;Grimontia;
3	0	0	3	OSD190_6_14_KI	Bacteria;Proteobacteria;Gammaproteobacteria;Vibrionales;Vibrionaceae;Photobacterium;
7	5	8	20	OSD190_6_14_KI	Bacteria;Proteobacteria;Gammaproteobacteria;Vibrionales;Vibrionaceae;Vibrio;
11	9	13	33	OSD190_6_14_KI	Bacteria;Proteobacteria;Gammaproteobacteria;Xanthomonadales;JTB255 marine benthic group;
1	1	0	2	OSD190_6_14_KI	Bacteria;Proteobacteria;Gammaproteobacteria;Xanthomonadales;Nevskiaceae;Nevskia;
1	0	0	1	OSD190_6_14_KI	Bacteria;Proteobacteria;Gammaproteobacteria;Xanthomonadales;Solimonadaceae;Fontimonas;
1	1	1	3	OSD190_6_14_KI	Bacteria;Proteobacteria;Gammaproteobacteria;Xanthomonadales;Solimonadaceae;Polycyclovorans;
2	2	0	4	OSD190_6_14_KI	Bacteria;Proteobacteria;Gammaproteobacteria;Xanthomonadales;uncultured;
2	4	0	6	OSD190_6_14_KI	Bacteria;Proteobacteria;Gammaproteobacteria;Xanthomonadales;Xanthomonadaceae;Stenotrophomonas;
1	0	0	1	OSD190_6_14_KI	Bacteria;Proteobacteria;Gammaproteobacteria;Xanthomonadales;Xanthomonadales Incertae Sedis;Steroidobacter;
2	2	0	4	OSD190_6_14_KI	Bacteria;Proteobacteria;JdFBHP3;
1	0	0	1	OSD190_6_14_KI	Bacteria;Proteobacteria;Proteobacteria Incertae Sedis;Unknown Order;Unknown Family;Candidatus Tenderia;
6	6	3	15	OSD190_6_14_KI	Bacteria;Proteobacteria;SPOTSOCT00m83;
7	14	23	44	OSD190_6_14_KI	Bacteria;SBR1093;
1	0	0	1	OSD190_6_14_KI	Bacteria;Tectomicrobia;
5	8	3	16	OSD190_6_14_KI	Bacteria;Verrucomicrobia;Arctic97B-4 marine group;
2	3	1	6	OSD190_6_14_KI	Bacteria;Verrucomicrobia;OPB35 soil group;
1	0	0	1	OSD190_6_14_KI	Bacteria;Verrucomicrobia;Opitutae;A714019;
13	8	1	22	OSD190_6_14_KI	Bacteria;Verrucomicrobia;Opitutae;MB11C04 marine group;
1	1	1	3	OSD190_6_14_KI	Bacteria;Verrucomicrobia;Opitutae;Puniceicoccales;Puniceicoccaceae;Cerasicoccus;
3	3	1	7	OSD190_6_14_KI	Bacteria;Verrucomicrobia;Opitutae;Puniceicoccales;Puniceicoccaceae;Lentimonas;
1	1	1	3	OSD190_6_14_KI	Bacteria;Verrucomicrobia;Opitutae;Puniceicoccales;Puniceicoccaceae;Pelagicoccus;
8	9	11	28	OSD190_6_14_KI	Bacteria;Verrucomicrobia;Verrucomicrobiae;Verrucomicrobiales;DEV007;
2	0	0	2	OSD190_6_14_KI	Bacteria;Verrucomicrobia;Verrucomicrobiae;Verrucomicrobiales;Rubritaleaceae;Rubritalea;
10	8	28	46	OSD190_6_14_KI	Bacteria;Verrucomicrobia;Verrucomicrobiae;Verrucomicrobiales;Verrucomicrobiaceae;Roseibacillus;
1	0	0	1	OSD190_6_14_KI	Bacteria;Verrucomicrobia;Verrucomicrobiae;Verrucomicrobiales;Verrucomicrobiaceae;uncultured;
129	251	319	699	OSD190_6_14_KI	No Relative
1	0	0	1	OSD191_6_14_DRW	Archaea;
1	0	0	1	OSD191_6_14_DRW	Archaea;Aenigmarchaeota;Deep Sea Euryarchaeotic Group(DSEG);
1	1	1	3	OSD191_6_14_DRW	Archaea;Bathyarchaeota;
1	0	0	1	OSD191_6_14_DRW	Archaea;Euryarchaeota;Thermoplasmata;Thermoplasmatales;AMOS1A-4113-D04;
2	1	1	4	OSD191_6_14_DRW	Archaea;Euryarchaeota;Thermoplasmata;Thermoplasmatales;CCA47;
68	287	593	948	OSD191_6_14_DRW	Archaea;Euryarchaeota;Thermoplasmata;Thermoplasmatales;Marine Group II;
3	3	10	16	OSD191_6_14_DRW	Archaea;Euryarchaeota;Thermoplasmata;Thermoplasmatales;Marine Group III;
1	0	0	1	OSD191_6_14_DRW	Archaea;Euryarchaeota;Thermoplasmata;Thermoplasmatales;MKCST-A3;
1	0	0	1	OSD191_6_14_DRW	Archaea;Lokiarchaeota;
1	0	0	1	OSD191_6_14_DRW	Archaea;Marine Hydrothermal Vent Group(MHVG);
1	0	0	1	OSD191_6_14_DRW	Archaea;Miscellaneous Euryarchaeotic Group(MEG);
1	0	0	1	OSD191_6_14_DRW	Archaea;Thaumarchaeota;Group C3;
10	27	34	71	OSD191_6_14_DRW	Archaea;Thaumarchaeota;Marine Group I;
4	23	55	82	OSD191_6_14_DRW	Archaea;Thaumarchaeota;Marine Group I;Unknown Order;Unknown Family;Candidatus Nitrosopelagicus;
12	48	46	106	OSD191_6_14_DRW	Archaea;Thaumarchaeota;Marine Group I;Unknown Order;Unknown Family;Candidatus Nitrosopumilus;
44	3	9	56	OSD191_6_14_DRW	Archaea;Woesearchaeota (DHVEG-6);
1	0	0	1	OSD191_6_14_DRW	Archaea;WSA2;20a-9;
2	0	0	2	OSD191_6_14_DRW	Bacteria;Acetothermia;Unknown Class;Unknown Order;Unknown Family;Candidatus Acetothermus;
1	0	0	1	OSD191_6_14_DRW	Bacteria;Acidobacteria;AT-s3-28;
2	1	2	5	OSD191_6_14_DRW	Bacteria;Acidobacteria;Blastocatellia;Blastocatellales;Blastocatellaceae (Subgroup 4);Blastocatella;
1	0	0	1	OSD191_6_14_DRW	Bacteria;Acidobacteria;Holophagae;Acanthopleuribacterales;Acanthopleuribacteraceae;Acanthopleuribacter;
2	0	0	2	OSD191_6_14_DRW	Bacteria;Acidobacteria;Holophagae;B276-D12;
1	0	0	1	OSD191_6_14_DRW	Bacteria;Acidobacteria;Holophagae;Subgroup 10;NS72;
8	2	0	10	OSD191_6_14_DRW	Bacteria;Acidobacteria;Holophagae;Subgroup 10;Sva0725;
4	0	0	4	OSD191_6_14_DRW	Bacteria;Acidobacteria;Solibacteres;Solibacterales;Solibacteraceae (Subgroup 3);PAUC26f;
6	2	0	8	OSD191_6_14_DRW	Bacteria;Acidobacteria;Subgroup 21;
33	5	2	40	OSD191_6_14_DRW	Bacteria;Acidobacteria;Subgroup 22;
4	1	0	5	OSD191_6_14_DRW	Bacteria;Acidobacteria;Subgroup 26;
1	0	0	1	OSD191_6_14_DRW	Bacteria;Acidobacteria;Subgroup 9;
2	0	0	2	OSD191_6_14_DRW	Bacteria;Actinobacteria;Acidimicrobiia;Acidimicrobiales;Acidimicrobiaceae;Ilumatobacter;
9	8	6	23	OSD191_6_14_DRW	Bacteria;Actinobacteria;Acidimicrobiia;Acidimicrobiales;Acidimicrobiaceae;uncultured;
16	4	3	23	OSD191_6_14_DRW	Bacteria;Actinobacteria;Acidimicrobiia;Acidimicrobiales;OM1 clade;
180	713	1204	2097	OSD191_6_14_DRW	Bacteria;Actinobacteria;Acidimicrobiia;Acidimicrobiales;OM1 clade;Candidatus Actinomarina;
78	125	129	332	OSD191_6_14_DRW	Bacteria;Actinobacteria;Acidimicrobiia;Acidimicrobiales;Sva0996 marine group;
1	0	0	1	OSD191_6_14_DRW	Bacteria;Actinobacteria;Actinobacteria;PeM15;
1	0	0	1	OSD191_6_14_DRW	Bacteria;Actinobacteria;Actinobacteria;Streptomycetales;Streptomycetaceae;Streptomyces;
4	3	0	7	OSD191_6_14_DRW	Bacteria;Armatimonadetes;Fimbriimonadia;Fimbriimonadales;Fimbriimonadaceae;
5	0	0	5	OSD191_6_14_DRW	Bacteria;Bacteroidetes;Bacteroidetes BD2-2;
18	4	3	25	OSD191_6_14_DRW	Bacteria;Bacteroidetes;Bacteroidetes Incertae Sedis;Order II;Rhodothermaceae;uncultured;
1	0	0	1	OSD191_6_14_DRW	Bacteria;Bacteroidetes;Bacteroidetes Incertae Sedis;Order III;uncultured;
2	3	1	6	OSD191_6_14_DRW	Bacteria;Bacteroidetes;Bacteroidetes Incertae Sedis;Order III;Unknown Family;Balneola;
1	2	0	3	OSD191_6_14_DRW	Bacteria;Bacteroidetes;Bacteroidia;Bacteroidales;Marinilabiaceae;uncultured;
1	0	0	1	OSD191_6_14_DRW	Bacteria;Bacteroidetes;Bacteroidia;Bacteroidales;Prolixibacteraceae;Prolixibacter;
1	0	0	1	OSD191_6_14_DRW	Bacteria;Bacteroidetes;Bacteroidia;Bacteroidales;Rikenellaceae;Rikenella;
1	0	0	1	OSD191_6_14_DRW	Bacteria;Bacteroidetes;Bacteroidia;Bacteroidia Incertae Sedis;Draconibacteriaceae;Draconibacterium;
1	0	0	1	OSD191_6_14_DRW	Bacteria;Bacteroidetes;Cytophagia;Cytophagales;Cytophagaceae;Microscilla;
2	0	0	2	OSD191_6_14_DRW	Bacteria;Bacteroidetes;Cytophagia;Cytophagales;Flammeovirgaceae;Candidatus Amoebophilus;
3	2	0	5	OSD191_6_14_DRW	Bacteria;Bacteroidetes;Cytophagia;Cytophagales;Flammeovirgaceae;Ekhidna;
2	0	0	2	OSD191_6_14_DRW	Bacteria;Bacteroidetes;Cytophagia;Cytophagales;Flammeovirgaceae;Fabibacter;
5	1	0	6	OSD191_6_14_DRW	Bacteria;Bacteroidetes;Cytophagia;Cytophagales;Flammeovirgaceae;Flexithrix;
3	0	0	3	OSD191_6_14_DRW	Bacteria;Bacteroidetes;Cytophagia;Cytophagales;Flammeovirgaceae;Fulvivirga;
22	43	64	129	OSD191_6_14_DRW	Bacteria;Bacteroidetes;Cytophagia;Cytophagales;Flammeovirgaceae;Marinoscillum;
1	0	0	1	OSD191_6_14_DRW	Bacteria;Bacteroidetes;Cytophagia;Cytophagales;Flammeovirgaceae;Reichenbachiella;
54	25	13	92	OSD191_6_14_DRW	Bacteria;Bacteroidetes;Cytophagia;Cytophagales;Flammeovirgaceae;uncultured;
3	0	0	3	OSD191_6_14_DRW	Bacteria;Bacteroidetes;Flavobacteriia;Flavobacteriales;Cryomorphaceae;Crocinitomix;
44	101	143	288	OSD191_6_14_DRW	Bacteria;Bacteroidetes;Flavobacteriia;Flavobacteriales;Cryomorphaceae;Fluviicola;
4	0	1	5	OSD191_6_14_DRW	Bacteria;Bacteroidetes;Flavobacteriia;Flavobacteriales;Cryomorphaceae;NS10 marine group;
1	0	0	1	OSD191_6_14_DRW	Bacteria;Bacteroidetes;Flavobacteriia;Flavobacteriales;Cryomorphaceae;Owenweeksia;
6	13	10	29	OSD191_6_14_DRW	Bacteria;Bacteroidetes;Flavobacteriia;Flavobacteriales;Cryomorphaceae;Salinirepens;
19	22	24	65	OSD191_6_14_DRW	Bacteria;Bacteroidetes;Flavobacteriia;Flavobacteriales;Cryomorphaceae;uncultured;
1	0	0	1	OSD191_6_14_DRW	Bacteria;Bacteroidetes;Flavobacteriia;Flavobacteriales;Flavobacteriaceae;
2	1	2	5	OSD191_6_14_DRW	Bacteria;Bacteroidetes;Flavobacteriia;Flavobacteriales;Flavobacteriaceae;Actibacter;
7	3	2	12	OSD191_6_14_DRW	Bacteria;Bacteroidetes;Flavobacteriia;Flavobacteriales;Flavobacteriaceae;Aquibacter;
1	0	0	1	OSD191_6_14_DRW	Bacteria;Bacteroidetes;Flavobacteriia;Flavobacteriales;Flavobacteriaceae;Formosa;
2	0	0	2	OSD191_6_14_DRW	Bacteria;Bacteroidetes;Flavobacteriia;Flavobacteriales;Flavobacteriaceae;Lutibacter;
1	1	0	2	OSD191_6_14_DRW	Bacteria;Bacteroidetes;Flavobacteriia;Flavobacteriales;Flavobacteriaceae;Lutimonas;
4	7	5	16	OSD191_6_14_DRW	Bacteria;Bacteroidetes;Flavobacteriia;Flavobacteriales;Flavobacteriaceae;NS2b marine group;
34	76	13	123	OSD191_6_14_DRW	Bacteria;Bacteroidetes;Flavobacteriia;Flavobacteriales;Flavobacteriaceae;NS4 marine group;
167	521	1076	1764	OSD191_6_14_DRW	Bacteria;Bacteroidetes;Flavobacteriia;Flavobacteriales;Flavobacteriaceae;NS5 marine group;
1	1	0	2	OSD191_6_14_DRW	Bacteria;Bacteroidetes;Flavobacteriia;Flavobacteriales;Flavobacteriaceae;Robiginitalea;
3	1	1	5	OSD191_6_14_DRW	Bacteria;Bacteroidetes;Flavobacteriia;Flavobacteriales;Flavobacteriaceae;Tenacibaculum;
1	0	0	1	OSD191_6_14_DRW	Bacteria;Bacteroidetes;Flavobacteriia;Flavobacteriales;Flavobacteriaceae;Ulvibacter;
4	2	0	6	OSD191_6_14_DRW	Bacteria;Bacteroidetes;Flavobacteriia;Flavobacteriales;Flavobacteriaceae;uncultured;
1	0	0	1	OSD191_6_14_DRW	Bacteria;Bacteroidetes;Flavobacteriia;Flavobacteriales;Flavobacteriaceae;Winogradskyella;
3	11	12	26	OSD191_6_14_DRW	Bacteria;Bacteroidetes;Flavobacteriia;Flavobacteriales;NS7 marine group;
13	11	16	40	OSD191_6_14_DRW	Bacteria;Bacteroidetes;Flavobacteriia;Flavobacteriales;NS9 marine group;
1	0	0	1	OSD191_6_14_DRW	Bacteria;Bacteroidetes;SB-5;
1	0	0	1	OSD191_6_14_DRW	Bacteria;Bacteroidetes;Sphingobacteriia;Sphingobacteriales;KD1-131;
1	0	0	1	OSD191_6_14_DRW	Bacteria;Bacteroidetes;Sphingobacteriia;Sphingobacteriales;Lentimicrobiaceae;
1	0	0	1	OSD191_6_14_DRW	Bacteria;Bacteroidetes;Sphingobacteriia;Sphingobacteriales;NS11-12 marine group;
1	0	2	3	OSD191_6_14_DRW	Bacteria;Bacteroidetes;Sphingobacteriia;Sphingobacteriales;PHOS-HE51;
1	0	0	1	OSD191_6_14_DRW	Bacteria;Bacteroidetes;Sphingobacteriia;Sphingobacteriales;Saprospiraceae;
10	30	39	79	OSD191_6_14_DRW	Bacteria;Bacteroidetes;Sphingobacteriia;Sphingobacteriales;Saprospiraceae;Aureispira;
6	3	0	9	OSD191_6_14_DRW	Bacteria;Bacteroidetes;Sphingobacteriia;Sphingobacteriales;Saprospiraceae;Lewinella;
5	1	0	6	OSD191_6_14_DRW	Bacteria;Bacteroidetes;Sphingobacteriia;Sphingobacteriales;Saprospiraceae;Phaeodactylibacter;
5	0	0	5	OSD191_6_14_DRW	Bacteria;Bacteroidetes;Sphingobacteriia;Sphingobacteriales;Saprospiraceae;Portibacter;
1	0	0	1	OSD191_6_14_DRW	Bacteria;Bacteroidetes;Sphingobacteriia;Sphingobacteriales;Saprospiraceae;Saprospira;
36	20	10	66	OSD191_6_14_DRW	Bacteria;Bacteroidetes;Sphingobacteriia;Sphingobacteriales;Saprospiraceae;uncultured;
18	8	6	32	OSD191_6_14_DRW	Bacteria;Bacteroidetes;Sphingobacteriia;Sphingobacteriales;uncultured;
2	1	0	3	OSD191_6_14_DRW	Bacteria;BRC1;
2	0	0	2	OSD191_6_14_DRW	Bacteria;Chlamydiae;Chlamydiae;Chlamydiales;Chlamydiaceae;uncultured;
1	0	0	1	OSD191_6_14_DRW	Bacteria;Chlamydiae;Chlamydiae;Chlamydiales;Chlamydiales Incertae Sedis;
1	0	0	1	OSD191_6_14_DRW	Bacteria;Chlamydiae;Chlamydiae;Chlamydiales;Parachlamydiaceae;
1	0	0	1	OSD191_6_14_DRW	Bacteria;Chlamydiae;Chlamydiae;Chlamydiales;Parachlamydiaceae;Candidatus Protochlamydia;
1	0	0	1	OSD191_6_14_DRW	Bacteria;Chlamydiae;Chlamydiae;Chlamydiales;Parachlamydiaceae;Neochlamydia;
1	0	0	1	OSD191_6_14_DRW	Bacteria;Chlamydiae;Chlamydiae;Chlamydiales;Parachlamydiaceae;Parachlamydia;
1	0	0	1	OSD191_6_14_DRW	Bacteria;Chlamydiae;Chlamydiae;Chlamydiales;Simkaniaceae;
2	1	0	3	OSD191_6_14_DRW	Bacteria;Chlamydiae;Chlamydiae;Chlamydiales;Simkaniaceae;Candidatus Fritschea;
2	0	0	2	OSD191_6_14_DRW	Bacteria;Chlamydiae;Chlamydiae;Chlamydiales;Simkaniaceae;Simkania;
1	0	0	1	OSD191_6_14_DRW	Bacteria;Chlamydiae;Chlamydiae;Chlamydiales;Simkaniaceae;uncultured;
7	10	3	20	OSD191_6_14_DRW	Bacteria;Chlorobi;Chlorobia;Chlorobiales;Chlorobiaceae;Chlorobium;
2	0	0	2	OSD191_6_14_DRW	Bacteria;Chlorobi;Chlorobia;Chlorobiales;OC31;
1	0	0	1	OSD191_6_14_DRW	Bacteria;Chloroflexi;Anaerolineae;Anaerolineales;Anaerolineaceae;Ornatilinea;
22	10	1	33	OSD191_6_14_DRW	Bacteria;Chloroflexi;Anaerolineae;Anaerolineales;Anaerolineaceae;uncultured;
3	0	0	3	OSD191_6_14_DRW	Bacteria;Chloroflexi;Ardenticatenia;uncultured;
2	0	0	2	OSD191_6_14_DRW	Bacteria;Chloroflexi;Caldilineae;Caldilineales;Caldilineaceae;uncultured;
3	1	5	9	OSD191_6_14_DRW	Bacteria;Chloroflexi;JG30-KF-CM66;
17	13	7	37	OSD191_6_14_DRW	Bacteria;Chloroflexi;SAR202 clade;
1	0	0	1	OSD191_6_14_DRW	Bacteria;Chloroflexi;TK10;
259	526	460	1245	OSD191_6_14_DRW	Bacteria;Cyanobacteria;Chloroplast;
1	0	0	1	OSD191_6_14_DRW	Bacteria;Cyanobacteria;Cyanobacteria;SubsectionI;FamilyI;
1	0	0	1	OSD191_6_14_DRW	Bacteria;Cyanobacteria;Cyanobacteria;SubsectionI;FamilyI;Cyanobacterium;
122	144	94	360	OSD191_6_14_DRW	Bacteria;Cyanobacteria;Cyanobacteria;SubsectionI;FamilyI;Prochlorococcus;
305	1104	2520	3929	OSD191_6_14_DRW	Bacteria;Cyanobacteria;Cyanobacteria;SubsectionI;FamilyI;Synechococcus;
5	8	0	13	OSD191_6_14_DRW	Bacteria;Cyanobacteria;Cyanobacteria;SubsectionIII;FamilyI;Oscillatoria;
1	0	0	1	OSD191_6_14_DRW	Bacteria;Cyanobacteria;Cyanobacteria;SubsectionIII;FamilyI;Planktothricoides;
1	0	0	1	OSD191_6_14_DRW	Bacteria;Cyanobacteria;Cyanobacteria;SubsectionIII;FamilyI;Trichodesmium;
1	0	0	1	OSD191_6_14_DRW	Bacteria;Cyanobacteria;Cyanobacteria;SubsectionIV;FamilyII;Calothrix;
1	0	0	1	OSD191_6_14_DRW	Bacteria;Cyanobacteria;Melainabacteria;Caenarcaniphilales;
1	0	0	1	OSD191_6_14_DRW	Bacteria;Cyanobacteria;Melainabacteria;Obscuribacterales;
28	1	4	33	OSD191_6_14_DRW	Bacteria;Cyanobacteria;ML635J-21;
9	2	1	12	OSD191_6_14_DRW	Bacteria;Deferribacteres;Deferribacteres Incertae Sedis;Unknown Order;Unknown Family;Caldithrix;
4	1	0	5	OSD191_6_14_DRW	Bacteria;Deinococcus-Thermus;Deinococci;Deinococcales;Trueperaceae;Truepera;
1	0	0	1	OSD191_6_14_DRW	Bacteria;Deinococcus-Thermus;Deinococci;KD3-62;
1	0	0	1	OSD191_6_14_DRW	Bacteria;Elusimicrobia;Elusimicrobia;4-29;
2	0	0	2	OSD191_6_14_DRW	Bacteria;Elusimicrobia;Elusimicrobia;Lineage IIb;
1	0	0	1	OSD191_6_14_DRW	Bacteria;Elusimicrobia;Elusimicrobia;Lineage IV;
1	0	0	1	OSD191_6_14_DRW	Bacteria;Elusimicrobia;Elusimicrobia;MD2894-B20;
1	0	0	1	OSD191_6_14_DRW	Bacteria;FCPU426;
1	0	0	1	OSD191_6_14_DRW	Bacteria;Fibrobacteres;Chitinivibrionia;possible order 07;
3	0	0	3	OSD191_6_14_DRW	Bacteria;Fibrobacteres;Fibrobacteria;Fibrobacterales;Fibrobacteraceae;uncultured;
1	0	0	1	OSD191_6_14_DRW	Bacteria;Firmicutes;Clostridia;Clostridiales;Peptococcaceae;uncultured;
1	0	0	1	OSD191_6_14_DRW	Bacteria;Firmicutes;Clostridia;Clostridiales;Peptostreptococcaceae;Intestinibacter;
4	1	0	5	OSD191_6_14_DRW	Bacteria;Firmicutes;Clostridia;Halanaerobiales;ODP1230B8.23;
2	1	0	3	OSD191_6_14_DRW	Bacteria;Fusobacteria;Fusobacteriia;Fusobacteriales;Fusobacteriaceae;Propionigenium;
1	0	0	1	OSD191_6_14_DRW	Bacteria;Gemmatimonadetes;AKAU4049;
41	18	28	87	OSD191_6_14_DRW	Bacteria;Gemmatimonadetes;BD2-11 terrestrial group;
2	0	0	2	OSD191_6_14_DRW	Bacteria;Gemmatimonadetes;Gemmatimonadetes;Gemmatimonadales;Gemmatimonadaceae;uncultured;
9	4	3	16	OSD191_6_14_DRW	Bacteria;Gemmatimonadetes;PAUC43f marine benthic group;
8	2	6	16	OSD191_6_14_DRW	Bacteria;Gracilibacteria;
11	1	1	13	OSD191_6_14_DRW	Bacteria;Hydrogenedentes;
1	0	0	1	OSD191_6_14_DRW	Bacteria;Ignavibacteriae;Ignavibacteria;Ignavibacteriales;BSV26;
1	1	0	2	OSD191_6_14_DRW	Bacteria;Ignavibacteriae;Ignavibacteria;Ignavibacteriales;IheB3-7;
15	2	0	17	OSD191_6_14_DRW	Bacteria;Latescibacteria;
2	0	0	2	OSD191_6_14_DRW	Bacteria;Latescibacteria;Latescibacteria Incertae Sedis;Unknown Order;Unknown Family;Candidatus Latescibacter;
10	3	2	15	OSD191_6_14_DRW	Bacteria;Lentisphaerae;Lentisphaeria;Lentisphaerales;Lentisphaeraceae;Lentisphaera;
3	1	0	4	OSD191_6_14_DRW	Bacteria;Lentisphaerae;Lentisphaeria;Victivallales;Arctic95B-14;
1	0	0	1	OSD191_6_14_DRW	Bacteria;Lentisphaerae;Lentisphaeria;Victivallales;PRD18C08;
3	3	4	10	OSD191_6_14_DRW	Bacteria;Lentisphaerae;Lentisphaeria;Victivallales;Victivallaceae;
15	9	11	35	OSD191_6_14_DRW	Bacteria;Lentisphaerae;Oligosphaeria;SS1-B-02-17;
145	468	672	1285	OSD191_6_14_DRW	Bacteria;Marinimicrobia (SAR406 clade);
2	0	0	2	OSD191_6_14_DRW	Bacteria;Microgenomates;Candidatus Woesebacteria;
2	0	0	2	OSD191_6_14_DRW	Bacteria;Nitrospinae;Belgica2005-10-ZG-3;
1	0	0	1	OSD191_6_14_DRW	Bacteria;Nitrospinae;Nitrospinia;Nitrospinales;Nitrospinaceae;Nitrospina;
6	2	2	10	OSD191_6_14_DRW	Bacteria;Nitrospirae;Nitrospira;Nitrospirales;Nitrospiraceae;Nitrospira;
12	4	0	16	OSD191_6_14_DRW	Bacteria;Nitrospirae;Nitrospira;Nitrospirales;Nitrospiraceae;uncultured;
6	0	0	6	OSD191_6_14_DRW	Bacteria;Omnitrophica;
3	0	0	3	OSD191_6_14_DRW	Bacteria;Omnitrophica;Omnitrophica Incertae Sedis;Unknown Order;Unknown Family;Candidatus Omnitrophus;
2	0	0	2	OSD191_6_14_DRW	Bacteria;Parcubacteria;
1	0	0	1	OSD191_6_14_DRW	Bacteria;Parcubacteria;Candidatus Campbellbacteria;
2	0	0	2	OSD191_6_14_DRW	Bacteria;Parcubacteria;Candidatus Magasanikbacteria;
1	0	0	1	OSD191_6_14_DRW	Bacteria;Parcubacteria;Candidatus Nomurabacteria;
4	0	1	5	OSD191_6_14_DRW	Bacteria;PAUC34f;
2	0	0	2	OSD191_6_14_DRW	Bacteria;Peregrinibacteria;
12	2	2	16	OSD191_6_14_DRW	Bacteria;Planctomycetes;BD7-11;
30	15	28	73	OSD191_6_14_DRW	Bacteria;Planctomycetes;OM190;
1	0	0	1	OSD191_6_14_DRW	Bacteria;Planctomycetes;Phycisphaerae;B103G10;
2	0	0	2	OSD191_6_14_DRW	Bacteria;Planctomycetes;Phycisphaerae;C86;
5	1	0	6	OSD191_6_14_DRW	Bacteria;Planctomycetes;Phycisphaerae;CCM11a;
3	1	0	4	OSD191_6_14_DRW	Bacteria;Planctomycetes;Phycisphaerae;MSB-3A7 sediment group;
7	2	0	9	OSD191_6_14_DRW	Bacteria;Planctomycetes;Phycisphaerae;MSBL9;
2	0	0	2	OSD191_6_14_DRW	Bacteria;Planctomycetes;Phycisphaerae;Phycisphaerales;Phycisphaeraceae;I-8;
6	0	0	6	OSD191_6_14_DRW	Bacteria;Planctomycetes;Phycisphaerae;Phycisphaerales;Phycisphaeraceae;SM1A02;
2	0	0	2	OSD191_6_14_DRW	Bacteria;Planctomycetes;Phycisphaerae;Phycisphaerales;Phycisphaeraceae;uncultured;
11	0	0	11	OSD191_6_14_DRW	Bacteria;Planctomycetes;Phycisphaerae;Phycisphaerales;Phycisphaeraceae;Urania-1B-19 marine sediment group;
1	0	0	1	OSD191_6_14_DRW	Bacteria;Planctomycetes;Phycisphaerae;Pla1 lineage;
26	4	1	31	OSD191_6_14_DRW	Bacteria;Planctomycetes;Pla3 lineage;
8	2	2	12	OSD191_6_14_DRW	Bacteria;Planctomycetes;Pla4 lineage;
1	1	0	2	OSD191_6_14_DRW	Bacteria;Planctomycetes;Planctomycetacia;Brocadiales;Brocadiaceae;Candidatus Scalindua;
1	0	0	1	OSD191_6_14_DRW	Bacteria;Planctomycetes;Planctomycetacia;Planctomycetales;Planctomycetaceae;
14	2	3	19	OSD191_6_14_DRW	Bacteria;Planctomycetes;Planctomycetacia;Planctomycetales;Planctomycetaceae;Blastopirellula;
7	0	1	8	OSD191_6_14_DRW	Bacteria;Planctomycetes;Planctomycetacia;Planctomycetales;Planctomycetaceae;Pirellula;
10	2	1	13	OSD191_6_14_DRW	Bacteria;Planctomycetes;Planctomycetacia;Planctomycetales;Planctomycetaceae;Planctomyces;
19	7	12	38	OSD191_6_14_DRW	Bacteria;Planctomycetes;Planctomycetacia;Planctomycetales;Planctomycetaceae;Rhodopirellula;
8	15	21	44	OSD191_6_14_DRW	Bacteria;Planctomycetes;Planctomycetacia;Planctomycetales;Planctomycetaceae;Rubripirellula;
7	0	1	8	OSD191_6_14_DRW	Bacteria;Planctomycetes;Planctomycetacia;Planctomycetales;Planctomycetaceae;uncultured;
7	0	0	7	OSD191_6_14_DRW	Bacteria;Planctomycetes;vadinHA49;
1	0	0	1	OSD191_6_14_DRW	Bacteria;Proteobacteria;
1	0	0	1	OSD191_6_14_DRW	Bacteria;Proteobacteria;AEGEAN-245;
2	0	0	2	OSD191_6_14_DRW	Bacteria;Proteobacteria;Alphaproteobacteria;Alphaproteobacteria Incertae Sedis;Unknown Family;Eilatimonas;
4	0	1	5	OSD191_6_14_DRW	Bacteria;Proteobacteria;Alphaproteobacteria;Alphaproteobacteria Incertae Sedis;Unknown Family;uncultured;
1	0	0	1	OSD191_6_14_DRW	Bacteria;Proteobacteria;Alphaproteobacteria;Caulobacterales;Caulobacteraceae;uncultured;
1	0	0	1	OSD191_6_14_DRW	Bacteria;Proteobacteria;Alphaproteobacteria;Caulobacterales;Hyphomonadaceae;Maricaulis;
1	0	1	2	OSD191_6_14_DRW	Bacteria;Proteobacteria;Alphaproteobacteria;Kordiimonadales;Kordiimonadaceae;Kordiimonas;
1	0	0	1	OSD191_6_14_DRW	Bacteria;Proteobacteria;Alphaproteobacteria;Parvularculales;Parvularculaceae;
1	0	0	1	OSD191_6_14_DRW	Bacteria;Proteobacteria;Alphaproteobacteria;Parvularculales;Parvularculaceae;Amphiplicatus;
2	1	1	4	OSD191_6_14_DRW	Bacteria;Proteobacteria;Alphaproteobacteria;Rhizobiales;Bradyrhizobiaceae;Bradyrhizobium;
6	2	2	10	OSD191_6_14_DRW	Bacteria;Proteobacteria;Alphaproteobacteria;Rhizobiales;Hyphomicrobiaceae;Filomicrobium;
2	0	0	2	OSD191_6_14_DRW	Bacteria;Proteobacteria;Alphaproteobacteria;Rhizobiales;KF-JG30-B3;
11	7	13	31	OSD191_6_14_DRW	Bacteria;Proteobacteria;Alphaproteobacteria;Rhizobiales;OCS116 clade;
1	0	0	1	OSD191_6_14_DRW	Bacteria;Proteobacteria;Alphaproteobacteria;Rhizobiales;Phyllobacteriaceae;Mesorhizobium;
2	0	0	2	OSD191_6_14_DRW	Bacteria;Proteobacteria;Alphaproteobacteria;Rhizobiales;Phyllobacteriaceae;Pseudahrensia;
4	1	1	6	OSD191_6_14_DRW	Bacteria;Proteobacteria;Alphaproteobacteria;Rhizobiales;Phyllobacteriaceae;uncultured;
14	23	21	58	OSD191_6_14_DRW	Bacteria;Proteobacteria;Alphaproteobacteria;Rhizobiales;PS1 clade;
2	1	0	3	OSD191_6_14_DRW	Bacteria;Proteobacteria;Alphaproteobacteria;Rhizobiales;Rhodobiaceae;Afifella;
3	1	2	6	OSD191_6_14_DRW	Bacteria;Proteobacteria;Alphaproteobacteria;Rhizobiales;Rhodobiaceae;Anderseniella;
1	2	0	3	OSD191_6_14_DRW	Bacteria;Proteobacteria;Alphaproteobacteria;Rhizobiales;Rhodobiaceae;Methyloceanibacter;
10	16	8	34	OSD191_6_14_DRW	Bacteria;Proteobacteria;Alphaproteobacteria;Rhizobiales;Rhodobiaceae;Rhodobium;
3	1	2	6	OSD191_6_14_DRW	Bacteria;Proteobacteria;Alphaproteobacteria;Rhizobiales;Rhodobiaceae;uncultured;
4	4	0	8	OSD191_6_14_DRW	Bacteria;Proteobacteria;Alphaproteobacteria;Rhizobiales;uncultured;
3	0	0	3	OSD191_6_14_DRW	Bacteria;Proteobacteria;Alphaproteobacteria;Rhodobacterales;Rhodobacteraceae;Actibacterium;
2	34	61	97	OSD191_6_14_DRW	Bacteria;Proteobacteria;Alphaproteobacteria;Rhodobacterales;Rhodobacteraceae;Cribrihabitans;
1	0	0	1	OSD191_6_14_DRW	Bacteria;Proteobacteria;Alphaproteobacteria;Rhodobacterales;Rhodobacteraceae;Hwanghaeicola;
1	1	0	2	OSD191_6_14_DRW	Bacteria;Proteobacteria;Alphaproteobacteria;Rhodobacterales;Rhodobacteraceae;Jhaorihella;
1	0	0	1	OSD191_6_14_DRW	Bacteria;Proteobacteria;Alphaproteobacteria;Rhodobacterales;Rhodobacteraceae;Leisingera;
1	2	0	3	OSD191_6_14_DRW	Bacteria;Proteobacteria;Alphaproteobacteria;Rhodobacterales;Rhodobacteraceae;Litorimicrobium;
1	0	0	1	OSD191_6_14_DRW	Bacteria;Proteobacteria;Alphaproteobacteria;Rhodobacterales;Rhodobacteraceae;Loktanella;
1	0	0	1	OSD191_6_14_DRW	Bacteria;Proteobacteria;Alphaproteobacteria;Rhodobacterales;Rhodobacteraceae;Nautella;
1	0	0	1	OSD191_6_14_DRW	Bacteria;Proteobacteria;Alphaproteobacteria;Rhodobacterales;Rhodobacteraceae;Octadecabacter;
1	2	0	3	OSD191_6_14_DRW	Bacteria;Proteobacteria;Alphaproteobacteria;Rhodobacterales;Rhodobacteraceae;Pontivivens;
2	0	0	2	OSD191_6_14_DRW	Bacteria;Proteobacteria;Alphaproteobacteria;Rhodobacterales;Rhodobacteraceae;Roseivivax;
1	0	0	1	OSD191_6_14_DRW	Bacteria;Proteobacteria;Alphaproteobacteria;Rhodobacterales;Rhodobacteraceae;Roseobacter;
6	4	0	10	OSD191_6_14_DRW	Bacteria;Proteobacteria;Alphaproteobacteria;Rhodobacterales;Rhodobacteraceae;Roseovarius;
1	0	0	1	OSD191_6_14_DRW	Bacteria;Proteobacteria;Alphaproteobacteria;Rhodobacterales;Rhodobacteraceae;Ruegeria;
1	1	0	2	OSD191_6_14_DRW	Bacteria;Proteobacteria;Alphaproteobacteria;Rhodobacterales;Rhodobacteraceae;Sediminimonas;
1	0	0	1	OSD191_6_14_DRW	Bacteria;Proteobacteria;Alphaproteobacteria;Rhodobacterales;Rhodobacteraceae;Thalassobius;
1	7	0	8	OSD191_6_14_DRW	Bacteria;Proteobacteria;Alphaproteobacteria;Rhodobacterales;Rhodobacteraceae;Tropicimonas;
120	189	233	542	OSD191_6_14_DRW	Bacteria;Proteobacteria;Alphaproteobacteria;Rhodobacterales;Rhodobacteraceae;uncultured;
4	0	0	4	OSD191_6_14_DRW	Bacteria;Proteobacteria;Alphaproteobacteria;Rhodospirillales;AT-s3-44;
1	0	0	1	OSD191_6_14_DRW	Bacteria;Proteobacteria;Alphaproteobacteria;Rhodospirillales;MNC12;
1	0	0	1	OSD191_6_14_DRW	Bacteria;Proteobacteria;Alphaproteobacteria;Rhodospirillales;MSB-1E8;
1	0	0	1	OSD191_6_14_DRW	Bacteria;Proteobacteria;Alphaproteobacteria;Rhodospirillales;Rhodospirillaceae;
82	213	321	616	OSD191_6_14_DRW	Bacteria;Proteobacteria;Alphaproteobacteria;Rhodospirillales;Rhodospirillaceae;AEGEAN-169 marine group;
1	0	1	2	OSD191_6_14_DRW	Bacteria;Proteobacteria;Alphaproteobacteria;Rhodospirillales;Rhodospirillaceae;Fodinicurvata;
1	1	0	2	OSD191_6_14_DRW	Bacteria;Proteobacteria;Alphaproteobacteria;Rhodospirillales;Rhodospirillaceae;Magnetospira;
13	20	17	50	OSD191_6_14_DRW	Bacteria;Proteobacteria;Alphaproteobacteria;Rhodospirillales;Rhodospirillaceae;OM75 clade;
3	0	0	3	OSD191_6_14_DRW	Bacteria;Proteobacteria;Alphaproteobacteria;Rhodospirillales;Rhodospirillaceae;Pelagibius;
1	0	0	1	OSD191_6_14_DRW	Bacteria;Proteobacteria;Alphaproteobacteria;Rhodospirillales;Rhodospirillaceae;Terasakiella;
97	74	61	232	OSD191_6_14_DRW	Bacteria;Proteobacteria;Alphaproteobacteria;Rhodospirillales;Rhodospirillaceae;uncultured;
2	0	0	2	OSD191_6_14_DRW	Bacteria;Proteobacteria;Alphaproteobacteria;Rickettsiales;Holosporaceae;uncultured;
2	0	0	2	OSD191_6_14_DRW	Bacteria;Proteobacteria;Alphaproteobacteria;Rickettsiales;LWSR-14;
3	0	0	3	OSD191_6_14_DRW	Bacteria;Proteobacteria;Alphaproteobacteria;Rickettsiales;MD3-55;
24	23	21	68	OSD191_6_14_DRW	Bacteria;Proteobacteria;Alphaproteobacteria;Rickettsiales;Mitochondria;
6	2	0	8	OSD191_6_14_DRW	Bacteria;Proteobacteria;Alphaproteobacteria;Rickettsiales;Rickettsiaceae;uncultured;
1	0	0	1	OSD191_6_14_DRW	Bacteria;Proteobacteria;Alphaproteobacteria;Rickettsiales;Rickettsiales Incertae Sedis;uncultured;
57	142	166	365	OSD191_6_14_DRW	Bacteria;Proteobacteria;Alphaproteobacteria;Rickettsiales;S25-593;
105	246	234	585	OSD191_6_14_DRW	Bacteria;Proteobacteria;Alphaproteobacteria;Rickettsiales;SAR116 clade;
1	0	0	1	OSD191_6_14_DRW	Bacteria;Proteobacteria;Alphaproteobacteria;Rickettsiales;SAR116 clade;Candidatus Puniceispirillum;
2	0	0	2	OSD191_6_14_DRW	Bacteria;Proteobacteria;Alphaproteobacteria;Rickettsiales;SM2D12;
2	2	1	5	OSD191_6_14_DRW	Bacteria;Proteobacteria;Alphaproteobacteria;Rickettsiales;T9d;
1	0	0	1	OSD191_6_14_DRW	Bacteria;Proteobacteria;Alphaproteobacteria;Rickettsiales;TK34;
2	10	13	25	OSD191_6_14_DRW	Bacteria;Proteobacteria;Alphaproteobacteria;SAR11 clade;
42	178	217	437	OSD191_6_14_DRW	Bacteria;Proteobacteria;Alphaproteobacteria;SAR11 clade;Surface 1;
2	10	0	12	OSD191_6_14_DRW	Bacteria;Proteobacteria;Alphaproteobacteria;SAR11 clade;Surface 1;Candidatus Pelagibacter;
12	52	44	108	OSD191_6_14_DRW	Bacteria;Proteobacteria;Alphaproteobacteria;SAR11 clade;Surface 2;
2	1	3	6	OSD191_6_14_DRW	Bacteria;Proteobacteria;Alphaproteobacteria;SAR11 clade;Surface 4;
3	5	4	12	OSD191_6_14_DRW	Bacteria;Proteobacteria;Alphaproteobacteria;Sphingomonadales;Erythrobacteraceae;Altererythrobacter;
3	0	0	3	OSD191_6_14_DRW	Bacteria;Proteobacteria;Alphaproteobacteria;Sphingomonadales;Erythrobacteraceae;uncultured;
8	4	3	15	OSD191_6_14_DRW	Bacteria;Proteobacteria;Alphaproteobacteria;ss1-B-07-44;
3	2	0	5	OSD191_6_14_DRW	Bacteria;Proteobacteria;ARKICE-90;
1	0	0	1	OSD191_6_14_DRW	Bacteria;Proteobacteria;Betaproteobacteria;Burkholderiales;Alcaligenaceae;Achromobacter;
11	19	14	44	OSD191_6_14_DRW	Bacteria;Proteobacteria;Betaproteobacteria;Burkholderiales;Alcaligenaceae;MWH-UniP1 aquatic group;
1	0	0	1	OSD191_6_14_DRW	Bacteria;Proteobacteria;Betaproteobacteria;Burkholderiales;Burkholderiaceae;Polynucleobacter;
1	0	0	1	OSD191_6_14_DRW	Bacteria;Proteobacteria;Betaproteobacteria;Burkholderiales;Burkholderiaceae;Ralstonia;
1	0	0	1	OSD191_6_14_DRW	Bacteria;Proteobacteria;Betaproteobacteria;Burkholderiales;Comamonadaceae;uncultured;
2	0	0	2	OSD191_6_14_DRW	Bacteria;Proteobacteria;Betaproteobacteria;Burkholderiales;Oxalobacteraceae;Janthinobacterium;
25	39	45	109	OSD191_6_14_DRW	Bacteria;Proteobacteria;Betaproteobacteria;Hydrogenophilales;Hydrogenophilaceae;uncultured;
1	0	0	1	OSD191_6_14_DRW	Bacteria;Proteobacteria;Betaproteobacteria;Methylophilales;Methylophilaceae;Candidatus Methylopumilus;
1	0	0	1	OSD191_6_14_DRW	Bacteria;Proteobacteria;Betaproteobacteria;Methylophilales;Methylophilaceae;Methylophilus;
15	16	9	40	OSD191_6_14_DRW	Bacteria;Proteobacteria;Betaproteobacteria;Methylophilales;Methylophilaceae;OM43 clade;
1	0	0	1	OSD191_6_14_DRW	Bacteria;Proteobacteria;Betaproteobacteria;Nitrosomonadales;Nitrosomonadaceae;Nitrosomonas;
2	3	3	8	OSD191_6_14_DRW	Bacteria;Proteobacteria;BJGMM-U56;
1	0	0	1	OSD191_6_14_DRW	Bacteria;Proteobacteria;Deltaproteobacteria;43F-1404R;
2	0	0	2	OSD191_6_14_DRW	Bacteria;Proteobacteria;Deltaproteobacteria;Bdellovibrionales;Bacteriovoracaceae;
3	0	0	3	OSD191_6_14_DRW	Bacteria;Proteobacteria;Deltaproteobacteria;Bdellovibrionales;Bacteriovoracaceae;Deferrisoma;
4	0	0	4	OSD191_6_14_DRW	Bacteria;Proteobacteria;Deltaproteobacteria;Bdellovibrionales;Bacteriovoracaceae;Halobacteriovorax;
15	8	9	32	OSD191_6_14_DRW	Bacteria;Proteobacteria;Deltaproteobacteria;Bdellovibrionales;Bacteriovoracaceae;Peredibacter;
14	11	4	29	OSD191_6_14_DRW	Bacteria;Proteobacteria;Deltaproteobacteria;Bdellovibrionales;Bacteriovoracaceae;uncultured;
7	0	0	7	OSD191_6_14_DRW	Bacteria;Proteobacteria;Deltaproteobacteria;Bdellovibrionales;Bdellovibrionaceae;Bdellovibrio;
106	75	78	259	OSD191_6_14_DRW	Bacteria;Proteobacteria;Deltaproteobacteria;Bdellovibrionales;Bdellovibrionaceae;OM27 clade;
98	88	63	249	OSD191_6_14_DRW	Bacteria;Proteobacteria;Deltaproteobacteria;Bradymonadales;
5	3	0	8	OSD191_6_14_DRW	Bacteria;Proteobacteria;Deltaproteobacteria;Desulfarculales;Desulfarculaceae;Desulfatiglans;
1	0	0	1	OSD191_6_14_DRW	Bacteria;Proteobacteria;Deltaproteobacteria;Desulfobacterales;Desulfobacteraceae;Desulfobacter;
1	0	0	1	OSD191_6_14_DRW	Bacteria;Proteobacteria;Deltaproteobacteria;Desulfobacterales;Desulfobacteraceae;SEEP-SRB1;
23	23	9	55	OSD191_6_14_DRW	Bacteria;Proteobacteria;Deltaproteobacteria;Desulfobacterales;Desulfobacteraceae;Sva0081 sediment group;
1	0	0	1	OSD191_6_14_DRW	Bacteria;Proteobacteria;Deltaproteobacteria;Desulfobacterales;Desulfobacteraceae;uncultured;
19	19	6	44	OSD191_6_14_DRW	Bacteria;Proteobacteria;Deltaproteobacteria;Desulfobacterales;Desulfobulbaceae;Desulfobulbus;
1	0	0	1	OSD191_6_14_DRW	Bacteria;Proteobacteria;Deltaproteobacteria;Desulfobacterales;Desulfobulbaceae;uncultured;
41	30	43	114	OSD191_6_14_DRW	Bacteria;Proteobacteria;Deltaproteobacteria;Desulfurellales;Desulfurellaceae;H16;
1	0	0	1	OSD191_6_14_DRW	Bacteria;Proteobacteria;Deltaproteobacteria;Desulfuromonadales;C8S-102;
3	2	0	5	OSD191_6_14_DRW	Bacteria;Proteobacteria;Deltaproteobacteria;Desulfuromonadales;M113;
4	4	0	8	OSD191_6_14_DRW	Bacteria;Proteobacteria;Deltaproteobacteria;Desulfuromonadales;Sva1033;
1	0	0	1	OSD191_6_14_DRW	Bacteria;Proteobacteria;Deltaproteobacteria;Myxococcales;
2	0	0	2	OSD191_6_14_DRW	Bacteria;Proteobacteria;Deltaproteobacteria;Myxococcales;27F-1492R;
8	0	0	8	OSD191_6_14_DRW	Bacteria;Proteobacteria;Deltaproteobacteria;Myxococcales;bacteriap25;
8	3	1	12	OSD191_6_14_DRW	Bacteria;Proteobacteria;Deltaproteobacteria;Myxococcales;BIrii41;
11	2	2	15	OSD191_6_14_DRW	Bacteria;Proteobacteria;Deltaproteobacteria;Myxococcales;Blfdi19;
10	8	6	24	OSD191_6_14_DRW	Bacteria;Proteobacteria;Deltaproteobacteria;Myxococcales;Eel-36e1D6;
11	1	0	12	OSD191_6_14_DRW	Bacteria;Proteobacteria;Deltaproteobacteria;Myxococcales;Haliangiaceae;Haliangium;
2	1	0	3	OSD191_6_14_DRW	Bacteria;Proteobacteria;Deltaproteobacteria;Myxococcales;MidBa8;
1	0	0	1	OSD191_6_14_DRW	Bacteria;Proteobacteria;Deltaproteobacteria;Myxococcales;MSB-4B10;
2	0	0	2	OSD191_6_14_DRW	Bacteria;Proteobacteria;Deltaproteobacteria;Myxococcales;Nannocystaceae;
1	0	0	1	OSD191_6_14_DRW	Bacteria;Proteobacteria;Deltaproteobacteria;Myxococcales;Nannocystaceae;Enhygromyxa;
2	0	0	2	OSD191_6_14_DRW	Bacteria;Proteobacteria;Deltaproteobacteria;Myxococcales;Nannocystaceae;Nannocystis;
12	10	11	33	OSD191_6_14_DRW	Bacteria;Proteobacteria;Deltaproteobacteria;Myxococcales;Nannocystaceae;uncultured;
36	11	14	61	OSD191_6_14_DRW	Bacteria;Proteobacteria;Deltaproteobacteria;Myxococcales;P3OB-42;
2	0	0	2	OSD191_6_14_DRW	Bacteria;Proteobacteria;Deltaproteobacteria;Myxococcales;PS-B29;
6	3	2	11	OSD191_6_14_DRW	Bacteria;Proteobacteria;Deltaproteobacteria;Myxococcales;Sandaracinaceae;Sandaracinus;
12	5	7	24	OSD191_6_14_DRW	Bacteria;Proteobacteria;Deltaproteobacteria;Myxococcales;Sandaracinaceae;uncultured;
4	0	0	4	OSD191_6_14_DRW	Bacteria;Proteobacteria;Deltaproteobacteria;Myxococcales;UASB-TL25;
1	0	0	1	OSD191_6_14_DRW	Bacteria;Proteobacteria;Deltaproteobacteria;Myxococcales;VHS-B4-70;
42	7	0	49	OSD191_6_14_DRW	Bacteria;Proteobacteria;Deltaproteobacteria;NB1-j;
4	0	0	4	OSD191_6_14_DRW	Bacteria;Proteobacteria;Deltaproteobacteria;Oligoflexales;0319-6G20;
2	1	0	3	OSD191_6_14_DRW	Bacteria;Proteobacteria;Deltaproteobacteria;Oligoflexales;053A03-B-DI-P58;
33	16	7	56	OSD191_6_14_DRW	Bacteria;Proteobacteria;Deltaproteobacteria;Oligoflexales;Oligoflexaceae;
1	0	0	1	OSD191_6_14_DRW	Bacteria;Proteobacteria;Deltaproteobacteria;Oligoflexales;Oligoflexaceae;Pseudobacteriovorax;
90	166	203	459	OSD191_6_14_DRW	Bacteria;Proteobacteria;Deltaproteobacteria;SAR324 clade(Marine group B);
3	0	0	3	OSD191_6_14_DRW	Bacteria;Proteobacteria;Deltaproteobacteria;Sva0485;
1	0	0	1	OSD191_6_14_DRW	Bacteria;Proteobacteria;Deltaproteobacteria;Syntrophobacterales;Syntrophaceae;Desulfobacca;
7	4	5	16	OSD191_6_14_DRW	Bacteria;Proteobacteria;Deltaproteobacteria;Syntrophobacterales;Syntrophobacteraceae;uncultured;
3	0	0	3	OSD191_6_14_DRW	Bacteria;Proteobacteria;Elev-16S-509;
1	0	0	1	OSD191_6_14_DRW	Bacteria;Proteobacteria;Gammaproteobacteria;
1	0	0	1	OSD191_6_14_DRW	Bacteria;Proteobacteria;Gammaproteobacteria;Acidiferrobacterales;Acidiferrobacteraceae;Sulfurifustis;
1	0	0	1	OSD191_6_14_DRW	Bacteria;Proteobacteria;Gammaproteobacteria;Acidithiobacillales;RCP1-48;
1	0	0	1	OSD191_6_14_DRW	Bacteria;Proteobacteria;Gammaproteobacteria;Aeromonadales;Aeromonadaceae;Aeromonas;
1	0	0	1	OSD191_6_14_DRW	Bacteria;Proteobacteria;Gammaproteobacteria;Aeromonadales;Aeromonadaceae;uncultured;
2	0	0	2	OSD191_6_14_DRW	Bacteria;Proteobacteria;Gammaproteobacteria;Alteromonadales;Alteromonadaceae;Paraglaciecola;
1	0	0	1	OSD191_6_14_DRW	Bacteria;Proteobacteria;Gammaproteobacteria;Alteromonadales;Alteromonadaceae;uncultured;
1	1	1	3	OSD191_6_14_DRW	Bacteria;Proteobacteria;Gammaproteobacteria;Alteromonadales;Colwelliaceae;Colwellia;
3	1	0	4	OSD191_6_14_DRW	Bacteria;Proteobacteria;Gammaproteobacteria;Alteromonadales;Colwelliaceae;Thalassotalea;
1	0	0	1	OSD191_6_14_DRW	Bacteria;Proteobacteria;Gammaproteobacteria;Alteromonadales;Ferrimonadaceae;Ferrimonas;
2	0	0	2	OSD191_6_14_DRW	Bacteria;Proteobacteria;Gammaproteobacteria;Alteromonadales;Pseudoalteromonadaceae;Algicola;
2	0	0	2	OSD191_6_14_DRW	Bacteria;Proteobacteria;Gammaproteobacteria;Alteromonadales;Pseudoalteromonadaceae;Pseudoalteromonas;
2	1	0	3	OSD191_6_14_DRW	Bacteria;Proteobacteria;Gammaproteobacteria;Alteromonadales;Pseudoalteromonadaceae;Psychrosphaera;
1	0	0	1	OSD191_6_14_DRW	Bacteria;Proteobacteria;Gammaproteobacteria;Alteromonadales;Shewanellaceae;Shewanella;
1	0	0	1	OSD191_6_14_DRW	Bacteria;Proteobacteria;Gammaproteobacteria;Arenicellales;Arenicellaceae;Arenicella;
2	0	0	2	OSD191_6_14_DRW	Bacteria;Proteobacteria;Gammaproteobacteria;Arenicellales;Arenicellaceae;uncultured;
5	3	0	8	OSD191_6_14_DRW	Bacteria;Proteobacteria;Gammaproteobacteria;BD7-8 marine group;
1	0	0	1	OSD191_6_14_DRW	Bacteria;Proteobacteria;Gammaproteobacteria;Cardiobacteriales;Cardiobacteriaceae;uncultured;
1	0	0	1	OSD191_6_14_DRW	Bacteria;Proteobacteria;Gammaproteobacteria;Cellvibrionales;
1	3	4	8	OSD191_6_14_DRW	Bacteria;Proteobacteria;Gammaproteobacteria;Cellvibrionales;BD2-7;
1	0	0	1	OSD191_6_14_DRW	Bacteria;Proteobacteria;Gammaproteobacteria;Cellvibrionales;Cellvibrionaceae;Aestuariicella;
1	0	0	1	OSD191_6_14_DRW	Bacteria;Proteobacteria;Gammaproteobacteria;Cellvibrionales;Cellvibrionaceae;Maricurvus;
1	1	0	2	OSD191_6_14_DRW	Bacteria;Proteobacteria;Gammaproteobacteria;Cellvibrionales;Cellvibrionaceae;Marinimicrobium;
3	0	0	3	OSD191_6_14_DRW	Bacteria;Proteobacteria;Gammaproteobacteria;Cellvibrionales;Cellvibrionaceae;Simiduia;
9	3	0	12	OSD191_6_14_DRW	Bacteria;Proteobacteria;Gammaproteobacteria;Cellvibrionales;Cellvibrionaceae;uncultured;
1	0	0	1	OSD191_6_14_DRW	Bacteria;Proteobacteria;Gammaproteobacteria;Cellvibrionales;Halieaceae;
7	5	1	13	OSD191_6_14_DRW	Bacteria;Proteobacteria;Gammaproteobacteria;Cellvibrionales;Halieaceae;Haliea;
4	7	2	13	OSD191_6_14_DRW	Bacteria;Proteobacteria;Gammaproteobacteria;Cellvibrionales;Halieaceae;Halioglobus;
13	12	12	37	OSD191_6_14_DRW	Bacteria;Proteobacteria;Gammaproteobacteria;Cellvibrionales;Halieaceae;Luminiphilus;
79	97	91	267	OSD191_6_14_DRW	Bacteria;Proteobacteria;Gammaproteobacteria;Cellvibrionales;Halieaceae;OM60(NOR5) clade;
1	0	0	1	OSD191_6_14_DRW	Bacteria;Proteobacteria;Gammaproteobacteria;Cellvibrionales;Halieaceae;Parahaliea;
1	3	0	4	OSD191_6_14_DRW	Bacteria;Proteobacteria;Gammaproteobacteria;Cellvibrionales;Halieaceae;Pseudohaliea;
2	2	0	4	OSD191_6_14_DRW	Bacteria;Proteobacteria;Gammaproteobacteria;Cellvibrionales;Porticoccaceae;C1-B045;
11	4	0	15	OSD191_6_14_DRW	Bacteria;Proteobacteria;Gammaproteobacteria;Cellvibrionales;Spongiibacteraceae;BD1-7 clade;
2	1	1	4	OSD191_6_14_DRW	Bacteria;Proteobacteria;Gammaproteobacteria;Cellvibrionales;Spongiibacteraceae;Dasania;
2	0	0	2	OSD191_6_14_DRW	Bacteria;Proteobacteria;Gammaproteobacteria;Cellvibrionales;Spongiibacteraceae;Litorivivens;
5	0	0	5	OSD191_6_14_DRW	Bacteria;Proteobacteria;Gammaproteobacteria;Chromatiales;Ectothiorhodospiraceae;Thioalkalispira;
6	10	4	20	OSD191_6_14_DRW	Bacteria;Proteobacteria;Gammaproteobacteria;Chromatiales;Granulosicoccaceae;Granulosicoccus;
50	65	68	183	OSD191_6_14_DRW	Bacteria;Proteobacteria;Gammaproteobacteria;E01-9C-26 marine group;
6	0	0	6	OSD191_6_14_DRW	Bacteria;Proteobacteria;Gammaproteobacteria;EC3;
1	0	0	1	OSD191_6_14_DRW	Bacteria;Proteobacteria;Gammaproteobacteria;Enterobacteriales;Enterobacteriaceae;Buchnera;
30	20	117	167	OSD191_6_14_DRW	Bacteria;Proteobacteria;Gammaproteobacteria;Enterobacteriales;Enterobacteriaceae;Citrobacter;
27	75	9	111	OSD191_6_14_DRW	Bacteria;Proteobacteria;Gammaproteobacteria;Enterobacteriales;Enterobacteriaceae;Enterobacter;
6	3	0	9	OSD191_6_14_DRW	Bacteria;Proteobacteria;Gammaproteobacteria;Enterobacteriales;Enterobacteriaceae;Escherichia-Shigella;
2	2	0	4	OSD191_6_14_DRW	Bacteria;Proteobacteria;Gammaproteobacteria;Enterobacteriales;Enterobacteriaceae;Rahnella;
7	6	1	14	OSD191_6_14_DRW	Bacteria;Proteobacteria;Gammaproteobacteria;Enterobacteriales;Enterobacteriaceae;Raoultella;
24	35	41	100	OSD191_6_14_DRW	Bacteria;Proteobacteria;Gammaproteobacteria;Enterobacteriales;Enterobacteriaceae;Serratia;
2	2	0	4	OSD191_6_14_DRW	Bacteria;Proteobacteria;Gammaproteobacteria;Enterobacteriales;Enterobacteriaceae;Yersinia;
1	0	0	1	OSD191_6_14_DRW	Bacteria;Proteobacteria;Gammaproteobacteria;Gammaproteobacteria Incertae Sedis;Unknown Family;Marinicella;
2	0	0	2	OSD191_6_14_DRW	Bacteria;Proteobacteria;Gammaproteobacteria;Gammaproteobacteria Incertae Sedis;Unknown Family;Sedimenticola;
1	0	0	1	OSD191_6_14_DRW	Bacteria;Proteobacteria;Gammaproteobacteria;Gammaproteobacteria Incertae Sedis;Unknown Family;Thiohalophilus;
1	0	0	1	OSD191_6_14_DRW	Bacteria;Proteobacteria;Gammaproteobacteria;Gammaproteobacteria Incertae Sedis;Unknown Family;Thiolapillus;
68	75	71	214	OSD191_6_14_DRW	Bacteria;Proteobacteria;Gammaproteobacteria;Gammaproteobacteria Incertae Sedis;Unknown Family;uncultured;
1	1	0	2	OSD191_6_14_DRW	Bacteria;Proteobacteria;Gammaproteobacteria;HOC36;
20	3	0	23	OSD191_6_14_DRW	Bacteria;Proteobacteria;Gammaproteobacteria;HTA4;
1	0	0	1	OSD191_6_14_DRW	Bacteria;Proteobacteria;Gammaproteobacteria;I3A;
26	25	13	64	OSD191_6_14_DRW	Bacteria;Proteobacteria;Gammaproteobacteria;KI89A clade;
73	39	26	138	OSD191_6_14_DRW	Bacteria;Proteobacteria;Gammaproteobacteria;Legionellales;Coxiellaceae;Coxiella;
3	3	0	6	OSD191_6_14_DRW	Bacteria;Proteobacteria;Gammaproteobacteria;Legionellales;Legionellaceae;uncultured;
1	0	0	1	OSD191_6_14_DRW	Bacteria;Proteobacteria;Gammaproteobacteria;Methylococcales;Methylococcaceae;Methylomonas;
1	0	0	1	OSD191_6_14_DRW	Bacteria;Proteobacteria;Gammaproteobacteria;Methylococcales;Methylococcaceae;Methylovulum;
1	0	0	1	OSD191_6_14_DRW	Bacteria;Proteobacteria;Gammaproteobacteria;Oceanospirillales;
4	2	0	6	OSD191_6_14_DRW	Bacteria;Proteobacteria;Gammaproteobacteria;Oceanospirillales;Alcanivoracaceae;Kangiella;
2	0	0	2	OSD191_6_14_DRW	Bacteria;Proteobacteria;Gammaproteobacteria;Oceanospirillales;CrystalBog021C3;
3	1	0	4	OSD191_6_14_DRW	Bacteria;Proteobacteria;Gammaproteobacteria;Oceanospirillales;Hahellaceae;Endozoicomonas;
1	0	0	1	OSD191_6_14_DRW	Bacteria;Proteobacteria;Gammaproteobacteria;Oceanospirillales;JL-ETNP-Y6;
5	7	8	20	OSD191_6_14_DRW	Bacteria;Proteobacteria;Gammaproteobacteria;Oceanospirillales;Litoricolaceae;Litoricola;
1	0	0	1	OSD191_6_14_DRW	Bacteria;Proteobacteria;Gammaproteobacteria;Oceanospirillales;Oceanospirillaceae;
1	0	0	1	OSD191_6_14_DRW	Bacteria;Proteobacteria;Gammaproteobacteria;Oceanospirillales;Oceanospirillaceae;Litoribacillus;
9	5	0	14	OSD191_6_14_DRW	Bacteria;Proteobacteria;Gammaproteobacteria;Oceanospirillales;Oceanospirillaceae;Marinobacterium;
1	1	0	2	OSD191_6_14_DRW	Bacteria;Proteobacteria;Gammaproteobacteria;Oceanospirillales;Oceanospirillaceae;Motiliproteus;
11	14	9	34	OSD191_6_14_DRW	Bacteria;Proteobacteria;Gammaproteobacteria;Oceanospirillales;Oceanospirillaceae;Pseudohongiella;
1	0	0	1	OSD191_6_14_DRW	Bacteria;Proteobacteria;Gammaproteobacteria;Oceanospirillales;Oceanospirillales Incertae Sedis;Gynuella;
1	0	0	1	OSD191_6_14_DRW	Bacteria;Proteobacteria;Gammaproteobacteria;Oceanospirillales;Oleiphilaceae;Oleiphilus;
39	81	87	207	OSD191_6_14_DRW	Bacteria;Proteobacteria;Gammaproteobacteria;Oceanospirillales;OM182 clade;
119	312	383	814	OSD191_6_14_DRW	Bacteria;Proteobacteria;Gammaproteobacteria;Oceanospirillales;SAR86 clade;
6	0	0	6	OSD191_6_14_DRW	Bacteria;Proteobacteria;Gammaproteobacteria;Oceanospirillales;SS1-B-06-26;
1	0	0	1	OSD191_6_14_DRW	Bacteria;Proteobacteria;Gammaproteobacteria;Pseudomonadales;Moraxellaceae;Moraxella;
1	0	0	1	OSD191_6_14_DRW	Bacteria;Proteobacteria;Gammaproteobacteria;Pseudomonadales;Pseudomonadaceae;Azotobacter;
7	4	3	14	OSD191_6_14_DRW	Bacteria;Proteobacteria;Gammaproteobacteria;Pseudomonadales;Pseudomonadaceae;Pseudomonas;
1	0	0	1	OSD191_6_14_DRW	Bacteria;Proteobacteria;Gammaproteobacteria;PYR10d3;
41	63	79	183	OSD191_6_14_DRW	Bacteria;Proteobacteria;Gammaproteobacteria;Salinisphaerales;Salinisphaeraceae;ZD0417 marine group;
1	1	0	2	OSD191_6_14_DRW	Bacteria;Proteobacteria;Gammaproteobacteria;SS1-B-09-64;
6	7	1	14	OSD191_6_14_DRW	Bacteria;Proteobacteria;Gammaproteobacteria;Sva0071;
2	0	0	2	OSD191_6_14_DRW	Bacteria;Proteobacteria;Gammaproteobacteria;Thiotrichales;1G93;
1	0	0	1	OSD191_6_14_DRW	Bacteria;Proteobacteria;Gammaproteobacteria;Thiotrichales;EV818SWSAP88;
4	0	1	5	OSD191_6_14_DRW	Bacteria;Proteobacteria;Gammaproteobacteria;Thiotrichales;H2-104-2;
1	0	0	1	OSD191_6_14_DRW	Bacteria;Proteobacteria;Gammaproteobacteria;Thiotrichales;Piscirickettsiaceae;endosymbionts;
1	1	0	2	OSD191_6_14_DRW	Bacteria;Proteobacteria;Gammaproteobacteria;Thiotrichales;Piscirickettsiaceae;uncultured;
1	0	0	1	OSD191_6_14_DRW	Bacteria;Proteobacteria;Gammaproteobacteria;Thiotrichales;Thiotrichaceae;Methylohalomonas;
6	2	3	11	OSD191_6_14_DRW	Bacteria;Proteobacteria;Gammaproteobacteria;Thiotrichales;Thiotrichaceae;Thiothrix;
2	0	0	2	OSD191_6_14_DRW	Bacteria;Proteobacteria;Gammaproteobacteria;Thiotrichales;Thiotrichaceae;uncultured;
3	0	2	5	OSD191_6_14_DRW	Bacteria;Proteobacteria;Gammaproteobacteria;Thiotrichales;Thiotrichales Incertae Sedis;Caedibacter;
4	6	5	15	OSD191_6_14_DRW	Bacteria;Proteobacteria;Gammaproteobacteria;Thiotrichales;Thiotrichales Incertae Sedis;Candidatus Endoecteinascidia;
49	17	10	76	OSD191_6_14_DRW	Bacteria;Proteobacteria;Gammaproteobacteria;uncultured;
1	1	0	2	OSD191_6_14_DRW	Bacteria;Proteobacteria;Gammaproteobacteria;Vibrionales;Vibrionaceae;Enterovibrio;
2	2	0	4	OSD191_6_14_DRW	Bacteria;Proteobacteria;Gammaproteobacteria;Vibrionales;Vibrionaceae;Grimontia;
5	2	1	8	OSD191_6_14_DRW	Bacteria;Proteobacteria;Gammaproteobacteria;Vibrionales;Vibrionaceae;Photobacterium;
6	11	8	25	OSD191_6_14_DRW	Bacteria;Proteobacteria;Gammaproteobacteria;Vibrionales;Vibrionaceae;Vibrio;
1	0	0	1	OSD191_6_14_DRW	Bacteria;Proteobacteria;Gammaproteobacteria;X35;
103	94	50	247	OSD191_6_14_DRW	Bacteria;Proteobacteria;Gammaproteobacteria;Xanthomonadales;JTB255 marine benthic group;
9	8	0	17	OSD191_6_14_DRW	Bacteria;Proteobacteria;Gammaproteobacteria;Xanthomonadales;uncultured;
5	3	3	11	OSD191_6_14_DRW	Bacteria;Proteobacteria;Gammaproteobacteria;Xanthomonadales;Xanthomonadaceae;Stenotrophomonas;
4	0	2	6	OSD191_6_14_DRW	Bacteria;Proteobacteria;JdFBHP3;
2	0	0	2	OSD191_6_14_DRW	Bacteria;Proteobacteria;JTB23;
3	0	0	3	OSD191_6_14_DRW	Bacteria;Proteobacteria;MACA-EFT26;
1	1	0	2	OSD191_6_14_DRW	Bacteria;Proteobacteria;pItb-vmat-80;
1	0	0	1	OSD191_6_14_DRW	Bacteria;Proteobacteria;Proteobacteria Incertae Sedis;Unknown Order;Unknown Family;Candidatus Tenderia;
17	15	6	38	OSD191_6_14_DRW	Bacteria;Proteobacteria;SPOTSOCT00m83;
5	1	0	6	OSD191_6_14_DRW	Bacteria;RBG-1 (Zixibacteria);
1	0	0	1	OSD191_6_14_DRW	Bacteria;Saccharibacteria;
8	7	8	23	OSD191_6_14_DRW	Bacteria;SBR1093;
5	0	0	5	OSD191_6_14_DRW	Bacteria;Spirochaetae;Spirochaetes;Spirochaetales;Spirochaetaceae;Spirochaeta 2;
1	0	0	1	OSD191_6_14_DRW	Bacteria;SR1 (Absconditabacteria);
1	0	0	1	OSD191_6_14_DRW	Bacteria;Tectomicrobia;Tectomicrobia Incertae Sedis;Unknown Order;Unknown Family;Candidatus Entotheonella;
2	0	0	2	OSD191_6_14_DRW	Bacteria;Tenericutes;Mollicutes;Acholeplasmatales;Acholeplasmataceae;Acholeplasma;
3	0	0	3	OSD191_6_14_DRW	Bacteria;TM6 (Dependentiae);
11	20	21	52	OSD191_6_14_DRW	Bacteria;Verrucomicrobia;Arctic97B-4 marine group;
29	30	25	84	OSD191_6_14_DRW	Bacteria;Verrucomicrobia;OPB35 soil group;
1	0	0	1	OSD191_6_14_DRW	Bacteria;Verrucomicrobia;OPB35 soil group;Unknown Order;Unknown Family;Pedosphaera;
2	0	0	2	OSD191_6_14_DRW	Bacteria;Verrucomicrobia;Opitutae;A714019;
20	16	4	40	OSD191_6_14_DRW	Bacteria;Verrucomicrobia;Opitutae;MB11C04 marine group;
3	1	0	4	OSD191_6_14_DRW	Bacteria;Verrucomicrobia;Opitutae;Puniceicoccales;Puniceicoccaceae;Cerasicoccus;
7	7	4	18	OSD191_6_14_DRW	Bacteria;Verrucomicrobia;Opitutae;Puniceicoccales;Puniceicoccaceae;Lentimonas;
2	0	0	2	OSD191_6_14_DRW	Bacteria;Verrucomicrobia;Opitutae;Puniceicoccales;Puniceicoccaceae;Pelagicoccus;
4	3	0	7	OSD191_6_14_DRW	Bacteria;Verrucomicrobia;Opitutae;Puniceicoccales;Puniceicoccaceae;uncultured;
1	0	0	1	OSD191_6_14_DRW	Bacteria;Verrucomicrobia;R76-B128;
1	2	0	3	OSD191_6_14_DRW	Bacteria;Verrucomicrobia;S-BQ2-57 soil group;
28	24	44	96	OSD191_6_14_DRW	Bacteria;Verrucomicrobia;Verrucomicrobiae;Verrucomicrobiales;DEV007;
2	0	0	2	OSD191_6_14_DRW	Bacteria;Verrucomicrobia;Verrucomicrobiae;Verrucomicrobiales;Rubritaleaceae;Rubritalea;
1	0	1	2	OSD191_6_14_DRW	Bacteria;Verrucomicrobia;Verrucomicrobiae;Verrucomicrobiales;Verrucomicrobiaceae;Persicirhabdus;
4	3	0	7	OSD191_6_14_DRW	Bacteria;Verrucomicrobia;Verrucomicrobiae;Verrucomicrobiales;Verrucomicrobiaceae;Roseibacillus;
24	9	7	40	OSD191_6_14_DRW	Bacteria;Verrucomicrobia;WCHB1-41;
163	133	135	431	OSD191_6_14_DRW	No Relative
1	0	0	1	OSD31_6_14_PH	Archaea;Euryarchaeota;Halobacteria;Halobacteriales;Halobacteriaceae;Natronomonas;
79	209	256	544	OSD31_6_14_PH	Archaea;Euryarchaeota;Thermoplasmata;Thermoplasmatales;Marine Group II;
3	5	11	19	OSD31_6_14_PH	Archaea;Euryarchaeota;Thermoplasmata;Thermoplasmatales;Marine Group III;
2	0	0	2	OSD31_6_14_PH	Archaea;Thaumarchaeota;Marine Group I;
5	16	24	45	OSD31_6_14_PH	Archaea;Thaumarchaeota;Marine Group I;Unknown Order;Unknown Family;Candidatus Nitrosopelagicus;
3	6	5	14	OSD31_6_14_PH	Archaea;Thaumarchaeota;Marine Group I;Unknown Order;Unknown Family;Candidatus Nitrosopumilus;
1	0	1	2	OSD31_6_14_PH	Archaea;Woesearchaeota (DHVEG-6);
1	0	0	1	OSD31_6_14_PH	Bacteria;Acidobacteria;Solibacteres;Solibacterales;Solibacteraceae (Subgroup 3);Bryobacter;
5	8	6	19	OSD31_6_14_PH	Bacteria;Actinobacteria;Acidimicrobiia;Acidimicrobiales;Acidimicrobiaceae;uncultured;
206	533	982	1721	OSD31_6_14_PH	Bacteria;Actinobacteria;Acidimicrobiia;Acidimicrobiales;OM1 clade;Candidatus Actinomarina;
74	153	216	443	OSD31_6_14_PH	Bacteria;Actinobacteria;Acidimicrobiia;Acidimicrobiales;Sva0996 marine group;
1	0	0	1	OSD31_6_14_PH	Bacteria;Actinobacteria;Acidimicrobiia;Acidimicrobiales;uncultured;
1	0	0	1	OSD31_6_14_PH	Bacteria;Actinobacteria;Actinobacteria;Micrococcales;Microbacteriaceae;Lysinimonas;
1	0	0	1	OSD31_6_14_PH	Bacteria;Actinobacteria;Actinobacteria;Micrococcales;Microbacteriaceae;ML602J-51;
1	0	0	1	OSD31_6_14_PH	Bacteria;Actinobacteria;Actinobacteria;Micrococcales;Sanguibacteraceae;Sanguibacter;
1	0	0	1	OSD31_6_14_PH	Bacteria;Bacteroidetes;Bacteroidetes Incertae Sedis;Order III;Unknown Family;Balneola;
2	3	2	7	OSD31_6_14_PH	Bacteria;Bacteroidetes;Cytophagia;Cytophagales;Flammeovirgaceae;Fabibacter;
1	0	0	1	OSD31_6_14_PH	Bacteria;Bacteroidetes;Cytophagia;Cytophagales;Flammeovirgaceae;Flexithrix;
22	66	68	156	OSD31_6_14_PH	Bacteria;Bacteroidetes;Cytophagia;Cytophagales;Flammeovirgaceae;Marinoscillum;
1	0	0	1	OSD31_6_14_PH	Bacteria;Bacteroidetes;Cytophagia;Cytophagales;Flammeovirgaceae;Reichenbachiella;
11	13	3	27	OSD31_6_14_PH	Bacteria;Bacteroidetes;Cytophagia;Cytophagales;Flammeovirgaceae;uncultured;
1	0	0	1	OSD31_6_14_PH	Bacteria;Bacteroidetes;Flavobacteriia;Flavobacteriales;
7	4	4	15	OSD31_6_14_PH	Bacteria;Bacteroidetes;Flavobacteriia;Flavobacteriales;Cryomorphaceae;Crocinitomix;
26	17	20	63	OSD31_6_14_PH	Bacteria;Bacteroidetes;Flavobacteriia;Flavobacteriales;Cryomorphaceae;Fluviicola;
4	3	2	9	OSD31_6_14_PH	Bacteria;Bacteroidetes;Flavobacteriia;Flavobacteriales;Cryomorphaceae;NS10 marine group;
8	8	3	19	OSD31_6_14_PH	Bacteria;Bacteroidetes;Flavobacteriia;Flavobacteriales;Cryomorphaceae;Salinirepens;
73	123	140	336	OSD31_6_14_PH	Bacteria;Bacteroidetes;Flavobacteriia;Flavobacteriales;Cryomorphaceae;uncultured;
2	1	0	3	OSD31_6_14_PH	Bacteria;Bacteroidetes;Flavobacteriia;Flavobacteriales;Flavobacteriaceae;Actibacter;
2	2	0	4	OSD31_6_14_PH	Bacteria;Bacteroidetes;Flavobacteriia;Flavobacteriales;Flavobacteriaceae;Aquibacter;
1	0	0	1	OSD31_6_14_PH	Bacteria;Bacteroidetes;Flavobacteriia;Flavobacteriales;Flavobacteriaceae;Aureisphaera;
1	0	0	1	OSD31_6_14_PH	Bacteria;Bacteroidetes;Flavobacteriia;Flavobacteriales;Flavobacteriaceae;Aureitalea;
1	0	0	1	OSD31_6_14_PH	Bacteria;Bacteroidetes;Flavobacteriia;Flavobacteriales;Flavobacteriaceae;Croceibacter;
1	0	0	1	OSD31_6_14_PH	Bacteria;Bacteroidetes;Flavobacteriia;Flavobacteriales;Flavobacteriaceae;Dokdonia;
5	4	2	11	OSD31_6_14_PH	Bacteria;Bacteroidetes;Flavobacteriia;Flavobacteriales;Flavobacteriaceae;Flavicella;
1	0	0	1	OSD31_6_14_PH	Bacteria;Bacteroidetes;Flavobacteriia;Flavobacteriales;Flavobacteriaceae;Flavobacterium;
7	17	18	42	OSD31_6_14_PH	Bacteria;Bacteroidetes;Flavobacteriia;Flavobacteriales;Flavobacteriaceae;Formosa;
4	3	1	8	OSD31_6_14_PH	Bacteria;Bacteroidetes;Flavobacteriia;Flavobacteriales;Flavobacteriaceae;Gilvibacter;
3	2	0	5	OSD31_6_14_PH	Bacteria;Bacteroidetes;Flavobacteriia;Flavobacteriales;Flavobacteriaceae;Kordia;
1	0	0	1	OSD31_6_14_PH	Bacteria;Bacteroidetes;Flavobacteriia;Flavobacteriales;Flavobacteriaceae;Lacinutrix;
1	0	0	1	OSD31_6_14_PH	Bacteria;Bacteroidetes;Flavobacteriia;Flavobacteriales;Flavobacteriaceae;Mesoflavibacter;
76	197	325	598	OSD31_6_14_PH	Bacteria;Bacteroidetes;Flavobacteriia;Flavobacteriales;Flavobacteriaceae;NS2b marine group;
154	362	380	896	OSD31_6_14_PH	Bacteria;Bacteroidetes;Flavobacteriia;Flavobacteriales;Flavobacteriaceae;NS4 marine group;
167	499	685	1351	OSD31_6_14_PH	Bacteria;Bacteroidetes;Flavobacteriia;Flavobacteriales;Flavobacteriaceae;NS5 marine group;
2	2	1	5	OSD31_6_14_PH	Bacteria;Bacteroidetes;Flavobacteriia;Flavobacteriales;Flavobacteriaceae;Olleya;
5	0	0	5	OSD31_6_14_PH	Bacteria;Bacteroidetes;Flavobacteriia;Flavobacteriales;Flavobacteriaceae;Polaribacter 4;
9	4	1	14	OSD31_6_14_PH	Bacteria;Bacteroidetes;Flavobacteriia;Flavobacteriales;Flavobacteriaceae;Pseudofulvibacter;
1	0	1	2	OSD31_6_14_PH	Bacteria;Bacteroidetes;Flavobacteriia;Flavobacteriales;Flavobacteriaceae;Psychroflexus;
1	2	0	3	OSD31_6_14_PH	Bacteria;Bacteroidetes;Flavobacteriia;Flavobacteriales;Flavobacteriaceae;Psychroserpens;
2	0	1	3	OSD31_6_14_PH	Bacteria;Bacteroidetes;Flavobacteriia;Flavobacteriales;Flavobacteriaceae;Spongiimonas;
27	38	34	99	OSD31_6_14_PH	Bacteria;Bacteroidetes;Flavobacteriia;Flavobacteriales;Flavobacteriaceae;Tenacibaculum;
1	0	0	1	OSD31_6_14_PH	Bacteria;Bacteroidetes;Flavobacteriia;Flavobacteriales;Flavobacteriaceae;Ulvibacter;
12	2	6	20	OSD31_6_14_PH	Bacteria;Bacteroidetes;Flavobacteriia;Flavobacteriales;Flavobacteriaceae;uncultured;
7	2	0	9	OSD31_6_14_PH	Bacteria;Bacteroidetes;Flavobacteriia;Flavobacteriales;Flavobacteriaceae;Winogradskyella;
19	24	28	71	OSD31_6_14_PH	Bacteria;Bacteroidetes;Flavobacteriia;Flavobacteriales;NS7 marine group;
236	361	411	1008	OSD31_6_14_PH	Bacteria;Bacteroidetes;Flavobacteriia;Flavobacteriales;NS9 marine group;
1	0	0	1	OSD31_6_14_PH	Bacteria;Bacteroidetes;Sphingobacteriia;Sphingobacteriales;Chitinophagaceae;Ferruginibacter;
1	0	0	1	OSD31_6_14_PH	Bacteria;Bacteroidetes;Sphingobacteriia;Sphingobacteriales;Chitinophagaceae;Parafilimonas;
3	1	0	4	OSD31_6_14_PH	Bacteria;Bacteroidetes;Sphingobacteriia;Sphingobacteriales;Saprospiraceae;Lewinella;
1	0	0	1	OSD31_6_14_PH	Bacteria;Bacteroidetes;Sphingobacteriia;Sphingobacteriales;Saprospiraceae;Phaeodactylibacter;
2	0	1	3	OSD31_6_14_PH	Bacteria;Bacteroidetes;Sphingobacteriia;Sphingobacteriales;Saprospiraceae;Rubidimonas;
20	31	36	87	OSD31_6_14_PH	Bacteria;Bacteroidetes;Sphingobacteriia;Sphingobacteriales;Saprospiraceae;uncultured;
2	0	0	2	OSD31_6_14_PH	Bacteria;Chlamydiae;Chlamydiae;Chlamydiales;Simkaniaceae;Candidatus Fritschea;
1	1	0	2	OSD31_6_14_PH	Bacteria;Chlorobi;Chlorobia;Chlorobiales;Chlorobiaceae;Chlorobium;
15	6	7	28	OSD31_6_14_PH	Bacteria;Chloroflexi;SAR202 clade;
399	698	628	1725	OSD31_6_14_PH	Bacteria;Cyanobacteria;Chloroplast;
124	165	83	372	OSD31_6_14_PH	Bacteria;Cyanobacteria;Cyanobacteria;SubsectionI;FamilyI;Prochlorococcus;
186	819	2157	3162	OSD31_6_14_PH	Bacteria;Cyanobacteria;Cyanobacteria;SubsectionI;FamilyI;Synechococcus;
1	0	0	1	OSD31_6_14_PH	Bacteria;Cyanobacteria;Cyanobacteria;SubsectionIII;FamilyI;Planktothricoides;
1	0	0	1	OSD31_6_14_PH	Bacteria;Cyanobacteria;Cyanobacteria;SubsectionIII;FamilyI;Trichodesmium;
1	0	0	1	OSD31_6_14_PH	Bacteria;Cyanobacteria;Melainabacteria;Obscuribacterales;
1	0	0	1	OSD31_6_14_PH	Bacteria;Cyanobacteria;ML635J-21;
2	0	0	2	OSD31_6_14_PH	Bacteria;Deinococcus-Thermus;Deinococci;Deinococcales;Deinococcaceae;Deinococcus;
2	1	0	3	OSD31_6_14_PH	Bacteria;Fibrobacteres;Fibrobacteria;Fibrobacterales;Fibrobacteraceae;uncultured;
1	0	0	1	OSD31_6_14_PH	Bacteria;Firmicutes;Bacilli;Bacillales;Staphylococcaceae;Staphylococcus;
1	0	0	1	OSD31_6_14_PH	Bacteria;Firmicutes;Bacilli;Lactobacillales;Streptococcaceae;Lactococcus;
1	0	0	1	OSD31_6_14_PH	Bacteria;Firmicutes;Bacilli;Lactobacillales;Streptococcaceae;Streptococcus;
1	0	0	1	OSD31_6_14_PH	Bacteria;Firmicutes;Clostridia;Clostridiales;Clostridiaceae 1;Clostridium sensu stricto 1;
1	2	0	3	OSD31_6_14_PH	Bacteria;Gemmatimonadetes;BD2-11 terrestrial group;
1	0	0	1	OSD31_6_14_PH	Bacteria;Gracilibacteria;
3	1	0	4	OSD31_6_14_PH	Bacteria;Lentisphaerae;Lentisphaeria;Lentisphaerales;Lentisphaeraceae;Lentisphaera;
1	0	0	1	OSD31_6_14_PH	Bacteria;Lentisphaerae;Oligosphaeria;SS1-B-02-17;
146	335	388	869	OSD31_6_14_PH	Bacteria;Marinimicrobia (SAR406 clade);
2	0	0	2	OSD31_6_14_PH	Bacteria;Parcubacteria;
1	0	0	1	OSD31_6_14_PH	Bacteria;PAUC34f;
1	0	0	1	OSD31_6_14_PH	Bacteria;Planctomycetes;BD7-11;
2	0	0	2	OSD31_6_14_PH	Bacteria;Planctomycetes;OM190;
11	2	3	16	OSD31_6_14_PH	Bacteria;Planctomycetes;Phycisphaerae;Phycisphaerales;Phycisphaeraceae;CL500-3;
3	4	2	9	OSD31_6_14_PH	Bacteria;Planctomycetes;Phycisphaerae;Phycisphaerales;Phycisphaeraceae;FS140-16B-02 marine group;
2	4	5	11	OSD31_6_14_PH	Bacteria;Planctomycetes;Phycisphaerae;Phycisphaerales;Phycisphaeraceae;Urania-1B-19 marine sediment group;
1	0	1	2	OSD31_6_14_PH	Bacteria;Planctomycetes;Planctomycetacia;Planctomycetales;Planctomycetaceae;Blastopirellula;
2	0	0	2	OSD31_6_14_PH	Bacteria;Planctomycetes;Planctomycetacia;Planctomycetales;Planctomycetaceae;Rhodopirellula;
2	0	0	2	OSD31_6_14_PH	Bacteria;Planctomycetes;Planctomycetacia;Planctomycetales;Planctomycetaceae;Rubripirellula;
1	0	0	1	OSD31_6_14_PH	Bacteria;Planctomycetes;Planctomycetacia;Planctomycetales;Planctomycetaceae;uncultured;
2	1	1	4	OSD31_6_14_PH	Bacteria;Proteobacteria;AEGEAN-245;
2	0	0	2	OSD31_6_14_PH	Bacteria;Proteobacteria;Alphaproteobacteria;Alphaproteobacteria Incertae Sedis;uncultured;
1	0	0	1	OSD31_6_14_PH	Bacteria;Proteobacteria;Alphaproteobacteria;Caulobacterales;Caulobacteraceae;Brevundimonas;
1	1	0	2	OSD31_6_14_PH	Bacteria;Proteobacteria;Alphaproteobacteria;Caulobacterales;Caulobacteraceae;Phenylobacterium;
1	0	0	1	OSD31_6_14_PH	Bacteria;Proteobacteria;Alphaproteobacteria;Caulobacterales;Hyphomonadaceae;Hirschia;
2	2	0	4	OSD31_6_14_PH	Bacteria;Proteobacteria;Alphaproteobacteria;Caulobacterales;Hyphomonadaceae;Maricaulis;
2	1	0	3	OSD31_6_14_PH	Bacteria;Proteobacteria;Alphaproteobacteria;Caulobacterales;Hyphomonadaceae;uncultured;
8	4	5	17	OSD31_6_14_PH	Bacteria;Proteobacteria;Alphaproteobacteria;Rhizobiales;Bradyrhizobiaceae;Bradyrhizobium;
1	0	0	1	OSD31_6_14_PH	Bacteria;Proteobacteria;Alphaproteobacteria;Rhizobiales;Brucellaceae;Ochrobactrum;
3	0	0	3	OSD31_6_14_PH	Bacteria;Proteobacteria;Alphaproteobacteria;Rhizobiales;Methylobacteriaceae;Methylobacterium;
2	1	0	3	OSD31_6_14_PH	Bacteria;Proteobacteria;Alphaproteobacteria;Rhizobiales;OCS116 clade;
2	0	0	2	OSD31_6_14_PH	Bacteria;Proteobacteria;Alphaproteobacteria;Rhizobiales;Phyllobacteriaceae;Ahrensia;
1	0	0	1	OSD31_6_14_PH	Bacteria;Proteobacteria;Alphaproteobacteria;Rhizobiales;Phyllobacteriaceae;Mesorhizobium;
1	0	0	1	OSD31_6_14_PH	Bacteria;Proteobacteria;Alphaproteobacteria;Rhizobiales;Phyllobacteriaceae;Pseudahrensia;
1	0	0	1	OSD31_6_14_PH	Bacteria;Proteobacteria;Alphaproteobacteria;Rhizobiales;Phyllobacteriaceae;uncultured;
62	144	171	377	OSD31_6_14_PH	Bacteria;Proteobacteria;Alphaproteobacteria;Rhizobiales;PS1 clade;
2	0	0	2	OSD31_6_14_PH	Bacteria;Proteobacteria;Alphaproteobacteria;Rhodobacterales;Rhodobacteraceae;Actibacterium;
1	0	0	1	OSD31_6_14_PH	Bacteria;Proteobacteria;Alphaproteobacteria;Rhodobacterales;Rhodobacteraceae;Amylibacter;
4	1	0	5	OSD31_6_14_PH	Bacteria;Proteobacteria;Alphaproteobacteria;Rhodobacterales;Rhodobacteraceae;Cribrihabitans;
2	7	4	13	OSD31_6_14_PH	Bacteria;Proteobacteria;Alphaproteobacteria;Rhodobacterales;Rhodobacteraceae;Donghicola;
1	1	0	2	OSD31_6_14_PH	Bacteria;Proteobacteria;Alphaproteobacteria;Rhodobacterales;Rhodobacteraceae;Epibacterium;
4	0	0	4	OSD31_6_14_PH	Bacteria;Proteobacteria;Alphaproteobacteria;Rhodobacterales;Rhodobacteraceae;Jannaschia;
1	9	6	16	OSD31_6_14_PH	Bacteria;Proteobacteria;Alphaproteobacteria;Rhodobacterales;Rhodobacteraceae;Litoreibacter;
1	0	1	2	OSD31_6_14_PH	Bacteria;Proteobacteria;Alphaproteobacteria;Rhodobacterales;Rhodobacteraceae;Planktomarina;
1	1	0	2	OSD31_6_14_PH	Bacteria;Proteobacteria;Alphaproteobacteria;Rhodobacterales;Rhodobacteraceae;Planktotalea;
2	0	0	2	OSD31_6_14_PH	Bacteria;Proteobacteria;Alphaproteobacteria;Rhodobacterales;Rhodobacteraceae;Rhodobacter;
2	1	8	11	OSD31_6_14_PH	Bacteria;Proteobacteria;Alphaproteobacteria;Rhodobacterales;Rhodobacteraceae;Roseibacterium;
1	0	0	1	OSD31_6_14_PH	Bacteria;Proteobacteria;Alphaproteobacteria;Rhodobacterales;Rhodobacteraceae;Roseivivax;
9	4	0	13	OSD31_6_14_PH	Bacteria;Proteobacteria;Alphaproteobacteria;Rhodobacterales;Rhodobacteraceae;Roseovarius;
2	1	0	3	OSD31_6_14_PH	Bacteria;Proteobacteria;Alphaproteobacteria;Rhodobacterales;Rhodobacteraceae;Ruegeria;
7	2	0	9	OSD31_6_14_PH	Bacteria;Proteobacteria;Alphaproteobacteria;Rhodobacterales;Rhodobacteraceae;Sediminimonas;
1	0	1	2	OSD31_6_14_PH	Bacteria;Proteobacteria;Alphaproteobacteria;Rhodobacterales;Rhodobacteraceae;Shimia;
1	0	0	1	OSD31_6_14_PH	Bacteria;Proteobacteria;Alphaproteobacteria;Rhodobacterales;Rhodobacteraceae;Tropicibacter;
211	614	800	1625	OSD31_6_14_PH	Bacteria;Proteobacteria;Alphaproteobacteria;Rhodobacterales;Rhodobacteraceae;uncultured;
4	0	0	4	OSD31_6_14_PH	Bacteria;Proteobacteria;Alphaproteobacteria;Rhodospirillales;AT-s3-44;
105	251	266	622	OSD31_6_14_PH	Bacteria;Proteobacteria;Alphaproteobacteria;Rhodospirillales;Rhodospirillaceae;AEGEAN-169 marine group;
5	6	6	17	OSD31_6_14_PH	Bacteria;Proteobacteria;Alphaproteobacteria;Rhodospirillales;Rhodospirillaceae;OM75 clade;
1	0	0	1	OSD31_6_14_PH	Bacteria;Proteobacteria;Alphaproteobacteria;Rhodospirillales;Rhodospirillaceae;Thalassospira;
43	59	49	151	OSD31_6_14_PH	Bacteria;Proteobacteria;Alphaproteobacteria;Rhodospirillales;Rhodospirillaceae;uncultured;
2	0	0	2	OSD31_6_14_PH	Bacteria;Proteobacteria;Alphaproteobacteria;Rhodospirillales;Rhodospirillales Incertae Sedis;Reyranella;
2	1	0	3	OSD31_6_14_PH	Bacteria;Proteobacteria;Alphaproteobacteria;Rickettsiales;Holosporaceae;uncultured;
2	0	1	3	OSD31_6_14_PH	Bacteria;Proteobacteria;Alphaproteobacteria;Rickettsiales;LWSR-14;
6	0	0	6	OSD31_6_14_PH	Bacteria;Proteobacteria;Alphaproteobacteria;Rickettsiales;MD3-55;
22	24	20	66	OSD31_6_14_PH	Bacteria;Proteobacteria;Alphaproteobacteria;Rickettsiales;Mitochondria;
2	0	0	2	OSD31_6_14_PH	Bacteria;Proteobacteria;Alphaproteobacteria;Rickettsiales;Rickettsiaceae;uncultured;
1	1	2	4	OSD31_6_14_PH	Bacteria;Proteobacteria;Alphaproteobacteria;Rickettsiales;Rickettsiales Incertae Sedis;Candidatus Hepatincola;
1	0	0	1	OSD31_6_14_PH	Bacteria;Proteobacteria;Alphaproteobacteria;Rickettsiales;Rickettsiales Incertae Sedis;uncultured;
57	85	44	186	OSD31_6_14_PH	Bacteria;Proteobacteria;Alphaproteobacteria;Rickettsiales;S25-593;
155	219	221	595	OSD31_6_14_PH	Bacteria;Proteobacteria;Alphaproteobacteria;Rickettsiales;SAR116 clade;
2	32	15	49	OSD31_6_14_PH	Bacteria;Proteobacteria;Alphaproteobacteria;Rickettsiales;SAR116 clade;Candidatus Puniceispirillum;
13	22	41	76	OSD31_6_14_PH	Bacteria;Proteobacteria;Alphaproteobacteria;SAR11 clade;
1	0	0	1	OSD31_6_14_PH	Bacteria;Proteobacteria;Alphaproteobacteria;SAR11 clade;Chesapeake-Delaware Bay;
8	0	0	8	OSD31_6_14_PH	Bacteria;Proteobacteria;Alphaproteobacteria;SAR11 clade;Deep 1;
101	247	271	619	OSD31_6_14_PH	Bacteria;Proteobacteria;Alphaproteobacteria;SAR11 clade;Surface 1;
12	30	3	45	OSD31_6_14_PH	Bacteria;Proteobacteria;Alphaproteobacteria;SAR11 clade;Surface 2;
2	2	0	4	OSD31_6_14_PH	Bacteria;Proteobacteria;Alphaproteobacteria;SAR11 clade;Surface 3;
31	38	32	101	OSD31_6_14_PH	Bacteria;Proteobacteria;Alphaproteobacteria;SAR11 clade;Surface 4;
2	0	0	2	OSD31_6_14_PH	Bacteria;Proteobacteria;Alphaproteobacteria;Sphingomonadales;Erythrobacteraceae;Altererythrobacter;
9	9	9	27	OSD31_6_14_PH	Bacteria;Proteobacteria;Alphaproteobacteria;Sphingomonadales;Erythrobacteraceae;Erythrobacter;
2	1	1	4	OSD31_6_14_PH	Bacteria;Proteobacteria;Alphaproteobacteria;Sphingomonadales;Erythrobacteraceae;Porphyrobacter;
1	0	0	1	OSD31_6_14_PH	Bacteria;Proteobacteria;Alphaproteobacteria;Sphingomonadales;Sphingomonadaceae;Novosphingobium;
2	0	0	2	OSD31_6_14_PH	Bacteria;Proteobacteria;Alphaproteobacteria;Sphingomonadales;Sphingomonadaceae;Rhizorhapis;
1	0	0	1	OSD31_6_14_PH	Bacteria;Proteobacteria;Alphaproteobacteria;Sphingomonadales;Sphingomonadaceae;Sphingobium;
1	0	0	1	OSD31_6_14_PH	Bacteria;Proteobacteria;Alphaproteobacteria;Sphingomonadales;Sphingomonadaceae;Sphingomonas;
2	0	0	2	OSD31_6_14_PH	Bacteria;Proteobacteria;Alphaproteobacteria;Sphingomonadales;Sphingomonadaceae;Sphingopyxis;
2	1	3	6	OSD31_6_14_PH	Bacteria;Proteobacteria;ARKICE-90;
5	6	2	13	OSD31_6_14_PH	Bacteria;Proteobacteria;Betaproteobacteria;Burkholderiales;Alcaligenaceae;MWH-UniP1 aquatic group;
1	0	0	1	OSD31_6_14_PH	Bacteria;Proteobacteria;Betaproteobacteria;Burkholderiales;Burkholderiaceae;Burkholderia-Paraburkholderia;
1	0	0	1	OSD31_6_14_PH	Bacteria;Proteobacteria;Betaproteobacteria;Burkholderiales;Burkholderiaceae;Pandoraea;
1	0	0	1	OSD31_6_14_PH	Bacteria;Proteobacteria;Betaproteobacteria;Burkholderiales;Burkholderiaceae;Polynucleobacter;
5	5	4	14	OSD31_6_14_PH	Bacteria;Proteobacteria;Betaproteobacteria;Burkholderiales;Burkholderiaceae;Ralstonia;
1	0	0	1	OSD31_6_14_PH	Bacteria;Proteobacteria;Betaproteobacteria;Burkholderiales;Oxalobacteraceae;Collimonas;
3	3	0	6	OSD31_6_14_PH	Bacteria;Proteobacteria;Betaproteobacteria;Hydrogenophilales;Hydrogenophilaceae;uncultured;
8	1	1	10	OSD31_6_14_PH	Bacteria;Proteobacteria;Betaproteobacteria;Methylophilales;Methylophilaceae;OM43 clade;
1	0	0	1	OSD31_6_14_PH	Bacteria;Proteobacteria;Deltaproteobacteria;Bdellovibrionales;Bacteriovoracaceae;Halobacteriovorax;
1	0	0	1	OSD31_6_14_PH	Bacteria;Proteobacteria;Deltaproteobacteria;Bdellovibrionales;Bacteriovoracaceae;Peredibacter;
1	1	3	5	OSD31_6_14_PH	Bacteria;Proteobacteria;Deltaproteobacteria;Bdellovibrionales;Bacteriovoracaceae;uncultured;
25	8	1	34	OSD31_6_14_PH	Bacteria;Proteobacteria;Deltaproteobacteria;Bdellovibrionales;Bdellovibrionaceae;OM27 clade;
7	2	2	11	OSD31_6_14_PH	Bacteria;Proteobacteria;Deltaproteobacteria;Bradymonadales;
2	0	1	3	OSD31_6_14_PH	Bacteria;Proteobacteria;Deltaproteobacteria;Desulfurellales;Desulfurellaceae;H16;
2	0	0	2	OSD31_6_14_PH	Bacteria;Proteobacteria;Deltaproteobacteria;Myxococcales;BIrii41;
5	0	5	10	OSD31_6_14_PH	Bacteria;Proteobacteria;Deltaproteobacteria;Myxococcales;Blfdi19;
1	0	0	1	OSD31_6_14_PH	Bacteria;Proteobacteria;Deltaproteobacteria;Myxococcales;Eel-36e1D6;
3	1	0	4	OSD31_6_14_PH	Bacteria;Proteobacteria;Deltaproteobacteria;Myxococcales;P3OB-42;
1	0	0	1	OSD31_6_14_PH	Bacteria;Proteobacteria;Deltaproteobacteria;Myxococcales;Sandaracinaceae;uncultured;
5	2	14	21	OSD31_6_14_PH	Bacteria;Proteobacteria;Deltaproteobacteria;Oligoflexales;Oligoflexaceae;
1	0	0	1	OSD31_6_14_PH	Bacteria;Proteobacteria;Deltaproteobacteria;Oligoflexales;Oligoflexaceae;Pseudobacteriovorax;
19	24	31	74	OSD31_6_14_PH	Bacteria;Proteobacteria;Deltaproteobacteria;SAR324 clade(Marine group B);
2	1	3	6	OSD31_6_14_PH	Bacteria;Proteobacteria;Epsilonproteobacteria;Campylobacterales;Campylobacteraceae;Arcobacter;
1	0	0	1	OSD31_6_14_PH	Bacteria;Proteobacteria;Epsilonproteobacteria;Campylobacterales;Helicobacteraceae;Sulfurovum;
2	0	0	2	OSD31_6_14_PH	Bacteria;Proteobacteria;Gammaproteobacteria;Aeromonadales;Aeromonadaceae;Aeromonas;
2	1	0	3	OSD31_6_14_PH	Bacteria;Proteobacteria;Gammaproteobacteria;Aeromonadales;Aeromonadaceae;uncultured;
1	0	0	1	OSD31_6_14_PH	Bacteria;Proteobacteria;Gammaproteobacteria;Alteromonadales;Alteromonadaceae;
4	1	0	5	OSD31_6_14_PH	Bacteria;Proteobacteria;Gammaproteobacteria;Alteromonadales;Alteromonadaceae;Aestuariibacter;
1	0	0	1	OSD31_6_14_PH	Bacteria;Proteobacteria;Gammaproteobacteria;Alteromonadales;Alteromonadaceae;Agaribacter;
1	0	0	1	OSD31_6_14_PH	Bacteria;Proteobacteria;Gammaproteobacteria;Alteromonadales;Alteromonadaceae;Alteromonas;
3	0	1	4	OSD31_6_14_PH	Bacteria;Proteobacteria;Gammaproteobacteria;Alteromonadales;Alteromonadaceae;Marinobacter;
4	1	2	7	OSD31_6_14_PH	Bacteria;Proteobacteria;Gammaproteobacteria;Alteromonadales;Alteromonadaceae;Paraglaciecola;
1	0	0	1	OSD31_6_14_PH	Bacteria;Proteobacteria;Gammaproteobacteria;Alteromonadales;Alteromonadaceae;Salinimonas;
1	4	2	7	OSD31_6_14_PH	Bacteria;Proteobacteria;Gammaproteobacteria;Alteromonadales;Alteromonadaceae;uncultured;
1	0	0	1	OSD31_6_14_PH	Bacteria;Proteobacteria;Gammaproteobacteria;Alteromonadales;Celerinatantimonadaceae;Celerinatantimonas;
7	3	5	15	OSD31_6_14_PH	Bacteria;Proteobacteria;Gammaproteobacteria;Alteromonadales;Colwelliaceae;Colwellia;
1	0	0	1	OSD31_6_14_PH	Bacteria;Proteobacteria;Gammaproteobacteria;Alteromonadales;Colwelliaceae;Thalassotalea;
1	0	0	1	OSD31_6_14_PH	Bacteria;Proteobacteria;Gammaproteobacteria;Alteromonadales;Idiomarinaceae;Idiomarina;
9	6	6	21	OSD31_6_14_PH	Bacteria;Proteobacteria;Gammaproteobacteria;Alteromonadales;Pseudoalteromonadaceae;Pseudoalteromonas;
1	0	0	1	OSD31_6_14_PH	Bacteria;Proteobacteria;Gammaproteobacteria;Alteromonadales;Pseudoalteromonadaceae;uncultured;
2	0	3	5	OSD31_6_14_PH	Bacteria;Proteobacteria;Gammaproteobacteria;Alteromonadales;Psychromonadaceae;Psychromonas;
3	0	0	3	OSD31_6_14_PH	Bacteria;Proteobacteria;Gammaproteobacteria;Alteromonadales;Shewanellaceae;Shewanella;
5	4	1	10	OSD31_6_14_PH	Bacteria;Proteobacteria;Gammaproteobacteria;Arenicellales;Arenicellaceae;Arenicella;
2	0	0	2	OSD31_6_14_PH	Bacteria;Proteobacteria;Gammaproteobacteria;Cellvibrionales;Cellvibrionaceae;Simiduia;
1	1	1	3	OSD31_6_14_PH	Bacteria;Proteobacteria;Gammaproteobacteria;Cellvibrionales;Cellvibrionaceae;Umboniibacter;
3	1	0	4	OSD31_6_14_PH	Bacteria;Proteobacteria;Gammaproteobacteria;Cellvibrionales;Cellvibrionaceae;uncultured;
7	3	1	11	OSD31_6_14_PH	Bacteria;Proteobacteria;Gammaproteobacteria;Cellvibrionales;Halieaceae;Haliea;
5	7	5	17	OSD31_6_14_PH	Bacteria;Proteobacteria;Gammaproteobacteria;Cellvibrionales;Halieaceae;Halioglobus;
1	0	0	1	OSD31_6_14_PH	Bacteria;Proteobacteria;Gammaproteobacteria;Cellvibrionales;Halieaceae;Luminiphilus;
71	130	130	331	OSD31_6_14_PH	Bacteria;Proteobacteria;Gammaproteobacteria;Cellvibrionales;Halieaceae;OM60(NOR5) clade;
5	2	0	7	OSD31_6_14_PH	Bacteria;Proteobacteria;Gammaproteobacteria;Cellvibrionales;Halieaceae;Parahaliea;
2	0	0	2	OSD31_6_14_PH	Bacteria;Proteobacteria;Gammaproteobacteria;Cellvibrionales;Halieaceae;Pseudohaliea;
6	8	3	17	OSD31_6_14_PH	Bacteria;Proteobacteria;Gammaproteobacteria;Cellvibrionales;Porticoccaceae;SAR92 clade;
7	5	2	14	OSD31_6_14_PH	Bacteria;Proteobacteria;Gammaproteobacteria;Cellvibrionales;Spongiibacteraceae;BD1-7 clade;
9	9	5	23	OSD31_6_14_PH	Bacteria;Proteobacteria;Gammaproteobacteria;E01-9C-26 marine group;
1	0	0	1	OSD31_6_14_PH	Bacteria;Proteobacteria;Gammaproteobacteria;Enterobacteriales;Enterobacteriaceae;
1	0	0	1	OSD31_6_14_PH	Bacteria;Proteobacteria;Gammaproteobacteria;Enterobacteriales;Enterobacteriaceae;Budvicia;
1	0	0	1	OSD31_6_14_PH	Bacteria;Proteobacteria;Gammaproteobacteria;Enterobacteriales;Enterobacteriaceae;Candidatus Blochmannia;
1	0	0	1	OSD31_6_14_PH	Bacteria;Proteobacteria;Gammaproteobacteria;Enterobacteriales;Enterobacteriaceae;Candidatus Rosenkranzia;
32	150	217	399	OSD31_6_14_PH	Bacteria;Proteobacteria;Gammaproteobacteria;Enterobacteriales;Enterobacteriaceae;Citrobacter;
21	11	15	47	OSD31_6_14_PH	Bacteria;Proteobacteria;Gammaproteobacteria;Enterobacteriales;Enterobacteriaceae;Enterobacter;
1	0	0	1	OSD31_6_14_PH	Bacteria;Proteobacteria;Gammaproteobacteria;Enterobacteriales;Enterobacteriaceae;Erwinia;
17	9	1	27	OSD31_6_14_PH	Bacteria;Proteobacteria;Gammaproteobacteria;Enterobacteriales;Enterobacteriaceae;Escherichia-Shigella;
3	5	2	10	OSD31_6_14_PH	Bacteria;Proteobacteria;Gammaproteobacteria;Enterobacteriales;Enterobacteriaceae;Klebsiella;
1	0	0	1	OSD31_6_14_PH	Bacteria;Proteobacteria;Gammaproteobacteria;Enterobacteriales;Enterobacteriaceae;Pantoea;
4	0	0	4	OSD31_6_14_PH	Bacteria;Proteobacteria;Gammaproteobacteria;Enterobacteriales;Enterobacteriaceae;Plesiomonas;
9	4	0	13	OSD31_6_14_PH	Bacteria;Proteobacteria;Gammaproteobacteria;Enterobacteriales;Enterobacteriaceae;Raoultella;
1	0	0	1	OSD31_6_14_PH	Bacteria;Proteobacteria;Gammaproteobacteria;Enterobacteriales;Enterobacteriaceae;Rosenbergiella;
21	67	81	169	OSD31_6_14_PH	Bacteria;Proteobacteria;Gammaproteobacteria;Enterobacteriales;Enterobacteriaceae;Serratia;
2	0	0	2	OSD31_6_14_PH	Bacteria;Proteobacteria;Gammaproteobacteria;Enterobacteriales;Enterobacteriaceae;Yersinia;
4	0	2	6	OSD31_6_14_PH	Bacteria;Proteobacteria;Gammaproteobacteria;Gammaproteobacteria Incertae Sedis;Unknown Family;Marinicella;
19	42	32	93	OSD31_6_14_PH	Bacteria;Proteobacteria;Gammaproteobacteria;Gammaproteobacteria Incertae Sedis;Unknown Family;uncultured;
3	1	1	5	OSD31_6_14_PH	Bacteria;Proteobacteria;Gammaproteobacteria;HTA4;
24	30	36	90	OSD31_6_14_PH	Bacteria;Proteobacteria;Gammaproteobacteria;KI89A clade;
10	0	1	11	OSD31_6_14_PH	Bacteria;Proteobacteria;Gammaproteobacteria;Legionellales;Coxiellaceae;Coxiella;
4	0	0	4	OSD31_6_14_PH	Bacteria;Proteobacteria;Gammaproteobacteria;Legionellales;Legionellaceae;uncultured;
2	0	0	2	OSD31_6_14_PH	Bacteria;Proteobacteria;Gammaproteobacteria;Oceanospirillales;Alcanivoracaceae;Alcanivorax;
2	0	0	2	OSD31_6_14_PH	Bacteria;Proteobacteria;Gammaproteobacteria;Oceanospirillales;Alcanivoracaceae;Kangiella;
1	0	0	1	OSD31_6_14_PH	Bacteria;Proteobacteria;Gammaproteobacteria;Oceanospirillales;Halomonadaceae;Chromohalobacter;
2	2	1	5	OSD31_6_14_PH	Bacteria;Proteobacteria;Gammaproteobacteria;Oceanospirillales;Halomonadaceae;Halomonas;
1	0	0	1	OSD31_6_14_PH	Bacteria;Proteobacteria;Gammaproteobacteria;Oceanospirillales;Halomonadaceae;Salinicola;
2	4	4	10	OSD31_6_14_PH	Bacteria;Proteobacteria;Gammaproteobacteria;Oceanospirillales;J8P41000-1F04;
4	3	0	7	OSD31_6_14_PH	Bacteria;Proteobacteria;Gammaproteobacteria;Oceanospirillales;JL-ETNP-Y6;
1	0	0	1	OSD31_6_14_PH	Bacteria;Proteobacteria;Gammaproteobacteria;Oceanospirillales;Litoricolaceae;Litoricola;
8	2	6	16	OSD31_6_14_PH	Bacteria;Proteobacteria;Gammaproteobacteria;Oceanospirillales;Oceanospirillaceae;Balneatrix;
9	2	0	11	OSD31_6_14_PH	Bacteria;Proteobacteria;Gammaproteobacteria;Oceanospirillales;Oceanospirillaceae;Marinobacterium;
14	12	19	45	OSD31_6_14_PH	Bacteria;Proteobacteria;Gammaproteobacteria;Oceanospirillales;Oceanospirillaceae;Pseudohongiella;
1	0	0	1	OSD31_6_14_PH	Bacteria;Proteobacteria;Gammaproteobacteria;Oceanospirillales;Oceanospirillaceae;Thalassolituus;
3	1	0	4	OSD31_6_14_PH	Bacteria;Proteobacteria;Gammaproteobacteria;Oceanospirillales;Oleiphilaceae;Oleiphilus;
6	6	5	17	OSD31_6_14_PH	Bacteria;Proteobacteria;Gammaproteobacteria;Oceanospirillales;OM182 clade;
315	639	835	1789	OSD31_6_14_PH	Bacteria;Proteobacteria;Gammaproteobacteria;Oceanospirillales;SAR86 clade;
24	29	47	100	OSD31_6_14_PH	Bacteria;Proteobacteria;Gammaproteobacteria;Oceanospirillales;ZD0405;
2	0	0	2	OSD31_6_14_PH	Bacteria;Proteobacteria;Gammaproteobacteria;Pseudomonadales;Moraxellaceae;Acinetobacter;
2	0	0	2	OSD31_6_14_PH	Bacteria;Proteobacteria;Gammaproteobacteria;Pseudomonadales;Moraxellaceae;Alkanindiges;
4	1	0	5	OSD31_6_14_PH	Bacteria;Proteobacteria;Gammaproteobacteria;Pseudomonadales;Moraxellaceae;Psychrobacter;
23	24	20	67	OSD31_6_14_PH	Bacteria;Proteobacteria;Gammaproteobacteria;Pseudomonadales;Pseudomonadaceae;Pseudomonas;
2	0	0	2	OSD31_6_14_PH	Bacteria;Proteobacteria;Gammaproteobacteria;Salinisphaerales;Salinisphaeraceae;Salinisphaera;
12	9	10	31	OSD31_6_14_PH	Bacteria;Proteobacteria;Gammaproteobacteria;Salinisphaerales;Salinisphaeraceae;ZD0417 marine group;
1	0	0	1	OSD31_6_14_PH	Bacteria;Proteobacteria;Gammaproteobacteria;Thiotrichales;Francisellaceae;Francisella;
1	1	0	2	OSD31_6_14_PH	Bacteria;Proteobacteria;Gammaproteobacteria;Thiotrichales;Piscirickettsiaceae;Marine Methylotrophic Group 3;
11	16	11	38	OSD31_6_14_PH	Bacteria;Proteobacteria;Gammaproteobacteria;Thiotrichales;Thiotrichaceae;Thiothrix;
1	0	0	1	OSD31_6_14_PH	Bacteria;Proteobacteria;Gammaproteobacteria;Thiotrichales;Thiotrichales Incertae Sedis;Caedibacter;
1	2	0	3	OSD31_6_14_PH	Bacteria;Proteobacteria;Gammaproteobacteria;Thiotrichales;uncultured;
2	0	0	2	OSD31_6_14_PH	Bacteria;Proteobacteria;Gammaproteobacteria;uncultured;
2	2	0	4	OSD31_6_14_PH	Bacteria;Proteobacteria;Gammaproteobacteria;Vibrionales;Vibrionaceae;Enterovibrio;
2	3	2	7	OSD31_6_14_PH	Bacteria;Proteobacteria;Gammaproteobacteria;Vibrionales;Vibrionaceae;Grimontia;
5	6	0	11	OSD31_6_14_PH	Bacteria;Proteobacteria;Gammaproteobacteria;Vibrionales;Vibrionaceae;Photobacterium;
4	3	1	8	OSD31_6_14_PH	Bacteria;Proteobacteria;Gammaproteobacteria;Vibrionales;Vibrionaceae;uncultured;
25	24	15	64	OSD31_6_14_PH	Bacteria;Proteobacteria;Gammaproteobacteria;Vibrionales;Vibrionaceae;Vibrio;
21	31	33	85	OSD31_6_14_PH	Bacteria;Proteobacteria;Gammaproteobacteria;Xanthomonadales;JTB255 marine benthic group;
1	1	0	2	OSD31_6_14_PH	Bacteria;Proteobacteria;Gammaproteobacteria;Xanthomonadales;Solimonadaceae;Fontimonas;
1	2	0	3	OSD31_6_14_PH	Bacteria;Proteobacteria;Gammaproteobacteria;Xanthomonadales;Xanthomonadaceae;Pseudoxanthomonas;
4	7	7	18	OSD31_6_14_PH	Bacteria;Proteobacteria;Gammaproteobacteria;Xanthomonadales;Xanthomonadaceae;Stenotrophomonas;
1	0	0	1	OSD31_6_14_PH	Bacteria;Proteobacteria;JdFBHP3;
1	1	0	2	OSD31_6_14_PH	Bacteria;Proteobacteria;SPOTSOCT00m83;
10	5	1	16	OSD31_6_14_PH	Bacteria;SBR1093;
1	0	0	1	OSD31_6_14_PH	Bacteria;Tenericutes;Mollicutes;Acholeplasmatales;Acholeplasmataceae;Acholeplasma;
3	0	2	5	OSD31_6_14_PH	Bacteria;Verrucomicrobia;Arctic97B-4 marine group;
2	0	0	2	OSD31_6_14_PH	Bacteria;Verrucomicrobia;OPB35 soil group;
1	0	0	1	OSD31_6_14_PH	Bacteria;Verrucomicrobia;Opitutae;MB11C04 marine group;
1	0	2	3	OSD31_6_14_PH	Bacteria;Verrucomicrobia;Opitutae;Puniceicoccales;Puniceicoccaceae;Coraliomargarita;
1	0	0	1	OSD31_6_14_PH	Bacteria;Verrucomicrobia;Opitutae;Puniceicoccales;Puniceicoccaceae;Lentimonas;
1	0	0	1	OSD31_6_14_PH	Bacteria;Verrucomicrobia;Opitutae;Puniceicoccales;Puniceicoccaceae;Pelagicoccus;
2	0	0	2	OSD31_6_14_PH	Bacteria;Verrucomicrobia;R76-B128;
15	28	22	65	OSD31_6_14_PH	Bacteria;Verrucomicrobia;Verrucomicrobiae;Verrucomicrobiales;DEV007;
5	3	6	14	OSD31_6_14_PH	Bacteria;Verrucomicrobia;Verrucomicrobiae;Verrucomicrobiales;Rubritaleaceae;Rubritalea;
1	0	0	1	OSD31_6_14_PH	Bacteria;Verrucomicrobia;Verrucomicrobiae;Verrucomicrobiales;Verrucomicrobiaceae;Persicirhabdus;
9	0	2	11	OSD31_6_14_PH	Bacteria;Verrucomicrobia;Verrucomicrobiae;Verrucomicrobiales;Verrucomicrobiaceae;Roseibacillus;
146	352	654	1152	OSD31_6_14_PH	No Relative
187	604	800	1591	OSD32_6_14_NSI	Archaea;Euryarchaeota;Thermoplasmata;Thermoplasmatales;Marine Group II;
22	49	82	153	OSD32_6_14_NSI	Archaea;Euryarchaeota;Thermoplasmata;Thermoplasmatales;Marine Group III;
3	2	6	11	OSD32_6_14_NSI	Archaea;Thaumarchaeota;Marine Group I;Unknown Order;Unknown Family;Candidatus Nitrosopelagicus;
1	3	0	4	OSD32_6_14_NSI	Archaea;Thaumarchaeota;Marine Group I;Unknown Order;Unknown Family;Candidatus Nitrosopumilus;
2	2	4	8	OSD32_6_14_NSI	Archaea;Woesearchaeota (DHVEG-6);
4	1	0	5	OSD32_6_14_NSI	Bacteria;Actinobacteria;Acidimicrobiia;Acidimicrobiales;Acidimicrobiaceae;uncultured;
174	645	1151	1970	OSD32_6_14_NSI	Bacteria;Actinobacteria;Acidimicrobiia;Acidimicrobiales;OM1 clade;Candidatus Actinomarina;
49	64	90	203	OSD32_6_14_NSI	Bacteria;Actinobacteria;Acidimicrobiia;Acidimicrobiales;Sva0996 marine group;
1	0	0	1	OSD32_6_14_NSI	Bacteria;Actinobacteria;Actinobacteria;Micrococcales;Microbacteriaceae;Naasia;
1	0	0	1	OSD32_6_14_NSI	Bacteria;Actinobacteria;Actinobacteria;Micrococcales;Micrococcaceae;Rothia;
2	3	0	5	OSD32_6_14_NSI	Bacteria;Bacteroidetes;Bacteroidetes Incertae Sedis;Order III;Unknown Family;Balneola;
1	0	0	1	OSD32_6_14_NSI	Bacteria;Bacteroidetes;Cytophagia;Cytophagales;Cytophagaceae;Sporocytophaga;
2	0	0	2	OSD32_6_14_NSI	Bacteria;Bacteroidetes;Cytophagia;Cytophagales;Flammeovirgaceae;Candidatus Amoebophilus;
3	1	2	6	OSD32_6_14_NSI	Bacteria;Bacteroidetes;Cytophagia;Cytophagales;Flammeovirgaceae;Ekhidna;
3	9	2	14	OSD32_6_14_NSI	Bacteria;Bacteroidetes;Cytophagia;Cytophagales;Flammeovirgaceae;Fabibacter;
12	37	69	118	OSD32_6_14_NSI	Bacteria;Bacteroidetes;Cytophagia;Cytophagales;Flammeovirgaceae;Marinoscillum;
1	0	0	1	OSD32_6_14_NSI	Bacteria;Bacteroidetes;Cytophagia;Cytophagales;Flammeovirgaceae;Reichenbachiella;
9	1	2	12	OSD32_6_14_NSI	Bacteria;Bacteroidetes;Cytophagia;Cytophagales;Flammeovirgaceae;uncultured;
1	1	0	2	OSD32_6_14_NSI	Bacteria;Bacteroidetes;Flavobacteriia;Flavobacteriales;
2	0	0	2	OSD32_6_14_NSI	Bacteria;Bacteroidetes;Flavobacteriia;Flavobacteriales;Cryomorphaceae;Crocinitomix;
5	3	3	11	OSD32_6_14_NSI	Bacteria;Bacteroidetes;Flavobacteriia;Flavobacteriales;Cryomorphaceae;Fluviicola;
7	2	5	14	OSD32_6_14_NSI	Bacteria;Bacteroidetes;Flavobacteriia;Flavobacteriales;Cryomorphaceae;NS10 marine group;
29	81	80	190	OSD32_6_14_NSI	Bacteria;Bacteroidetes;Flavobacteriia;Flavobacteriales;Cryomorphaceae;uncultured;
2	1	0	3	OSD32_6_14_NSI	Bacteria;Bacteroidetes;Flavobacteriia;Flavobacteriales;Flavobacteriaceae;Aquibacter;
1	1	0	2	OSD32_6_14_NSI	Bacteria;Bacteroidetes;Flavobacteriia;Flavobacteriales;Flavobacteriaceae;Aureisphaera;
4	2	1	7	OSD32_6_14_NSI	Bacteria;Bacteroidetes;Flavobacteriia;Flavobacteriales;Flavobacteriaceae;Flavicella;
1	0	0	1	OSD32_6_14_NSI	Bacteria;Bacteroidetes;Flavobacteriia;Flavobacteriales;Flavobacteriaceae;Formosa;
1	2	0	3	OSD32_6_14_NSI	Bacteria;Bacteroidetes;Flavobacteriia;Flavobacteriales;Flavobacteriaceae;Gilvibacter;
1	1	0	2	OSD32_6_14_NSI	Bacteria;Bacteroidetes;Flavobacteriia;Flavobacteriales;Flavobacteriaceae;Kordia;
30	123	268	421	OSD32_6_14_NSI	Bacteria;Bacteroidetes;Flavobacteriia;Flavobacteriales;Flavobacteriaceae;NS2b marine group;
66	108	85	259	OSD32_6_14_NSI	Bacteria;Bacteroidetes;Flavobacteriia;Flavobacteriales;Flavobacteriaceae;NS4 marine group;
54	140	198	392	OSD32_6_14_NSI	Bacteria;Bacteroidetes;Flavobacteriia;Flavobacteriales;Flavobacteriaceae;NS5 marine group;
2	1	0	3	OSD32_6_14_NSI	Bacteria;Bacteroidetes;Flavobacteriia;Flavobacteriales;Flavobacteriaceae;Polaribacter 4;
2	2	1	5	OSD32_6_14_NSI	Bacteria;Bacteroidetes;Flavobacteriia;Flavobacteriales;Flavobacteriaceae;Pseudofulvibacter;
18	28	29	75	OSD32_6_14_NSI	Bacteria;Bacteroidetes;Flavobacteriia;Flavobacteriales;Flavobacteriaceae;Tenacibaculum;
2	1	0	3	OSD32_6_14_NSI	Bacteria;Bacteroidetes;Flavobacteriia;Flavobacteriales;Flavobacteriaceae;uncultured;
1	0	0	1	OSD32_6_14_NSI	Bacteria;Bacteroidetes;Flavobacteriia;Flavobacteriales;Flavobacteriaceae;Winogradskyella;
9	9	8	26	OSD32_6_14_NSI	Bacteria;Bacteroidetes;Flavobacteriia;Flavobacteriales;NS7 marine group;
114	230	226	570	OSD32_6_14_NSI	Bacteria;Bacteroidetes;Flavobacteriia;Flavobacteriales;NS9 marine group;
1	0	0	1	OSD32_6_14_NSI	Bacteria;Bacteroidetes;Sphingobacteriia;Sphingobacteriales;Lentimicrobiaceae;
3	2	0	5	OSD32_6_14_NSI	Bacteria;Bacteroidetes;Sphingobacteriia;Sphingobacteriales;Saprospiraceae;Aureispira;
3	1	3	7	OSD32_6_14_NSI	Bacteria;Bacteroidetes;Sphingobacteriia;Sphingobacteriales;Saprospiraceae;Lewinella;
25	23	32	80	OSD32_6_14_NSI	Bacteria;Bacteroidetes;Sphingobacteriia;Sphingobacteriales;Saprospiraceae;uncultured;
1	0	0	1	OSD32_6_14_NSI	Bacteria;Bacteroidetes;Sphingobacteriia;Sphingobacteriales;uncultured;
1	0	0	1	OSD32_6_14_NSI	Bacteria;Chlamydiae;Chlamydiae;Chlamydiales;Chlamydiaceae;uncultured;
1	1	0	2	OSD32_6_14_NSI	Bacteria;Chlamydiae;Chlamydiae;Chlamydiales;Simkaniaceae;Candidatus Fritschea;
1	0	0	1	OSD32_6_14_NSI	Bacteria;Chlamydiae;Chlamydiae;Chlamydiales;Simkaniaceae;Simkania;
3	3	0	6	OSD32_6_14_NSI	Bacteria;Chlorobi;Chlorobia;Chlorobiales;Chlorobiaceae;Chlorobium;
1	1	0	2	OSD32_6_14_NSI	Bacteria;Chloroflexi;JG30-KF-CM66;
27	19	28	74	OSD32_6_14_NSI	Bacteria;Chloroflexi;SAR202 clade;
653	1761	1919	4333	OSD32_6_14_NSI	Bacteria;Cyanobacteria;Chloroplast;
1	0	0	1	OSD32_6_14_NSI	Bacteria;Cyanobacteria;Cyanobacteria;SubsectionI;FamilyI;
221	525	840	1586	OSD32_6_14_NSI	Bacteria;Cyanobacteria;Cyanobacteria;SubsectionI;FamilyI;Prochlorococcus;
172	690	1542	2404	OSD32_6_14_NSI	Bacteria;Cyanobacteria;Cyanobacteria;SubsectionI;FamilyI;Synechococcus;
2	0	0	2	OSD32_6_14_NSI	Bacteria;Cyanobacteria;ML635J-21;
2	1	0	3	OSD32_6_14_NSI	Bacteria;Fibrobacteres;Fibrobacteria;Fibrobacterales;Fibrobacteraceae;uncultured;
1	0	0	1	OSD32_6_14_NSI	Bacteria;Firmicutes;Bacilli;Bacillales;Bacillaceae;
1	0	0	1	OSD32_6_14_NSI	Bacteria;Firmicutes;Bacilli;Lactobacillales;Leuconostocaceae;Leuconostoc;
1	0	0	1	OSD32_6_14_NSI	Bacteria;Firmicutes;Clostridia;Clostridiales;Peptococcaceae;uncultured;
1	0	0	1	OSD32_6_14_NSI	Bacteria;Gemmatimonadetes;BD2-11 terrestrial group;
6	9	8	23	OSD32_6_14_NSI	Bacteria;Lentisphaerae;Lentisphaeria;Lentisphaerales;Lentisphaeraceae;Lentisphaera;
1	0	0	1	OSD32_6_14_NSI	Bacteria;Lentisphaerae;Oligosphaeria;SS1-B-02-17;
195	358	334	887	OSD32_6_14_NSI	Bacteria;Marinimicrobia (SAR406 clade);
1	0	0	1	OSD32_6_14_NSI	Bacteria;Nitrospirae;Nitrospira;Nitrospirales;Nitrospiraceae;Leptospirillum;
1	0	0	1	OSD32_6_14_NSI	Bacteria;PAUC34f;
3	2	1	6	OSD32_6_14_NSI	Bacteria;Planctomycetes;BD7-11;
1	0	0	1	OSD32_6_14_NSI	Bacteria;Planctomycetes;OM190;
2	0	0	2	OSD32_6_14_NSI	Bacteria;Planctomycetes;Phycisphaerae;Phycisphaerales;Phycisphaeraceae;CL500-3;
2	2	0	4	OSD32_6_14_NSI	Bacteria;Planctomycetes;Phycisphaerae;Phycisphaerales;Phycisphaeraceae;FS140-16B-02 marine group;
3	3	7	13	OSD32_6_14_NSI	Bacteria;Planctomycetes;Phycisphaerae;Phycisphaerales;Phycisphaeraceae;Urania-1B-19 marine sediment group;
1	1	0	2	OSD32_6_14_NSI	Bacteria;Planctomycetes;Planctomycetacia;Planctomycetales;Planctomycetaceae;Rhodopirellula;
3	0	0	3	OSD32_6_14_NSI	Bacteria;Planctomycetes;vadinHA49;
2	0	0	2	OSD32_6_14_NSI	Bacteria;Proteobacteria;AEGEAN-245;
2	0	1	3	OSD32_6_14_NSI	Bacteria;Proteobacteria;Alphaproteobacteria;Caulobacterales;Caulobacteraceae;Brevundimonas;
1	0	0	1	OSD32_6_14_NSI	Bacteria;Proteobacteria;Alphaproteobacteria;Caulobacterales;Caulobacteraceae;Caulobacter;
20	28	47	95	OSD32_6_14_NSI	Bacteria;Proteobacteria;Alphaproteobacteria;Caulobacterales;Caulobacteraceae;Phenylobacterium;
3	0	0	3	OSD32_6_14_NSI	Bacteria;Proteobacteria;Alphaproteobacteria;Caulobacterales;Caulobacteraceae;uncultured;
3	4	1	8	OSD32_6_14_NSI	Bacteria;Proteobacteria;Alphaproteobacteria;Caulobacterales;Hyphomonadaceae;Maricaulis;
1	1	1	3	OSD32_6_14_NSI	Bacteria;Proteobacteria;Alphaproteobacteria;Caulobacterales;Hyphomonadaceae;Oceanicaulis;
1	0	0	1	OSD32_6_14_NSI	Bacteria;Proteobacteria;Alphaproteobacteria;Caulobacterales;Hyphomonadaceae;uncultured;
1	0	0	1	OSD32_6_14_NSI	Bacteria;Proteobacteria;Alphaproteobacteria;Rhizobiales;Bradyrhizobiaceae;Afipia;
2	5	1	8	OSD32_6_14_NSI	Bacteria;Proteobacteria;Alphaproteobacteria;Rhizobiales;Bradyrhizobiaceae;Bradyrhizobium;
1	0	0	1	OSD32_6_14_NSI	Bacteria;Proteobacteria;Alphaproteobacteria;Rhizobiales;Bradyrhizobiaceae;Nitrobacter;
4	3	4	11	OSD32_6_14_NSI	Bacteria;Proteobacteria;Alphaproteobacteria;Rhizobiales;OCS116 clade;
1	0	0	1	OSD32_6_14_NSI	Bacteria;Proteobacteria;Alphaproteobacteria;Rhizobiales;Phyllobacteriaceae;Pseudahrensia;
73	133	147	353	OSD32_6_14_NSI	Bacteria;Proteobacteria;Alphaproteobacteria;Rhizobiales;PS1 clade;
1	0	0	1	OSD32_6_14_NSI	Bacteria;Proteobacteria;Alphaproteobacteria;Rhizobiales;Rhizobiaceae;Rhizobium;
1	0	0	1	OSD32_6_14_NSI	Bacteria;Proteobacteria;Alphaproteobacteria;Rhizobiales;Rhodobiaceae;Methyloligella;
1	0	0	1	OSD32_6_14_NSI	Bacteria;Proteobacteria;Alphaproteobacteria;Rhizobiales;Rhodobiaceae;Rhodobium;
1	0	0	1	OSD32_6_14_NSI	Bacteria;Proteobacteria;Alphaproteobacteria;Rhodobacterales;Rhodobacteraceae;Gemmobacter;
1	0	0	1	OSD32_6_14_NSI	Bacteria;Proteobacteria;Alphaproteobacteria;Rhodobacterales;Rhodobacteraceae;Halocynthiibacter;
2	0	0	2	OSD32_6_14_NSI	Bacteria;Proteobacteria;Alphaproteobacteria;Rhodobacterales;Rhodobacteraceae;Jannaschia;
1	12	5	18	OSD32_6_14_NSI	Bacteria;Proteobacteria;Alphaproteobacteria;Rhodobacterales;Rhodobacteraceae;Litoreibacter;
1	0	0	1	OSD32_6_14_NSI	Bacteria;Proteobacteria;Alphaproteobacteria;Rhodobacterales;Rhodobacteraceae;Maritimibacter;
3	0	0	3	OSD32_6_14_NSI	Bacteria;Proteobacteria;Alphaproteobacteria;Rhodobacterales;Rhodobacteraceae;Nautella;
1	0	0	1	OSD32_6_14_NSI	Bacteria;Proteobacteria;Alphaproteobacteria;Rhodobacterales;Rhodobacteraceae;Planktotalea;
1	1	0	2	OSD32_6_14_NSI	Bacteria;Proteobacteria;Alphaproteobacteria;Rhodobacterales;Rhodobacteraceae;Rhodobacter;
2	0	0	2	OSD32_6_14_NSI	Bacteria;Proteobacteria;Alphaproteobacteria;Rhodobacterales;Rhodobacteraceae;Rhodovulum;
3	0	0	3	OSD32_6_14_NSI	Bacteria;Proteobacteria;Alphaproteobacteria;Rhodobacterales;Rhodobacteraceae;Roseibacterium;
5	3	0	8	OSD32_6_14_NSI	Bacteria;Proteobacteria;Alphaproteobacteria;Rhodobacterales;Rhodobacteraceae;Roseovarius;
3	0	0	3	OSD32_6_14_NSI	Bacteria;Proteobacteria;Alphaproteobacteria;Rhodobacterales;Rhodobacteraceae;Ruegeria;
5	4	2	11	OSD32_6_14_NSI	Bacteria;Proteobacteria;Alphaproteobacteria;Rhodobacterales;Rhodobacteraceae;Sediminimonas;
6	6	7	19	OSD32_6_14_NSI	Bacteria;Proteobacteria;Alphaproteobacteria;Rhodobacterales;Rhodobacteraceae;Shimia;
2	0	0	2	OSD32_6_14_NSI	Bacteria;Proteobacteria;Alphaproteobacteria;Rhodobacterales;Rhodobacteraceae;Sulfitobacter;
1	1	0	2	OSD32_6_14_NSI	Bacteria;Proteobacteria;Alphaproteobacteria;Rhodobacterales;Rhodobacteraceae;Tateyamaria;
1	1	0	2	OSD32_6_14_NSI	Bacteria;Proteobacteria;Alphaproteobacteria;Rhodobacterales;Rhodobacteraceae;Thalassobius;
184	417	507	1108	OSD32_6_14_NSI	Bacteria;Proteobacteria;Alphaproteobacteria;Rhodobacterales;Rhodobacteraceae;uncultured;
2	3	2	7	OSD32_6_14_NSI	Bacteria;Proteobacteria;Alphaproteobacteria;Rhodospirillales;AT-s3-44;
99	238	293	630	OSD32_6_14_NSI	Bacteria;Proteobacteria;Alphaproteobacteria;Rhodospirillales;Rhodospirillaceae;AEGEAN-169 marine group;
2	6	9	17	OSD32_6_14_NSI	Bacteria;Proteobacteria;Alphaproteobacteria;Rhodospirillales;Rhodospirillaceae;OM75 clade;
2	0	1	3	OSD32_6_14_NSI	Bacteria;Proteobacteria;Alphaproteobacteria;Rhodospirillales;Rhodospirillaceae;Thalassospira;
50	53	40	143	OSD32_6_14_NSI	Bacteria;Proteobacteria;Alphaproteobacteria;Rhodospirillales;Rhodospirillaceae;uncultured;
2	0	2	4	OSD32_6_14_NSI	Bacteria;Proteobacteria;Alphaproteobacteria;Rhodospirillales;Rhodospirillales Incertae Sedis;Reyranella;
5	1	0	6	OSD32_6_14_NSI	Bacteria;Proteobacteria;Alphaproteobacteria;Rickettsiales;LWSR-14;
10	3	1	14	OSD32_6_14_NSI	Bacteria;Proteobacteria;Alphaproteobacteria;Rickettsiales;MD3-55;
35	89	83	207	OSD32_6_14_NSI	Bacteria;Proteobacteria;Alphaproteobacteria;Rickettsiales;Mitochondria;
2	0	0	2	OSD32_6_14_NSI	Bacteria;Proteobacteria;Alphaproteobacteria;Rickettsiales;Rickettsiaceae;Candidatus Cryptoprodotis;
1	0	0	1	OSD32_6_14_NSI	Bacteria;Proteobacteria;Alphaproteobacteria;Rickettsiales;Rickettsiaceae;Candidatus Gigarickettsia;
1	1	0	2	OSD32_6_14_NSI	Bacteria;Proteobacteria;Alphaproteobacteria;Rickettsiales;Rickettsiaceae;Orientia;
4	3	0	7	OSD32_6_14_NSI	Bacteria;Proteobacteria;Alphaproteobacteria;Rickettsiales;Rickettsiaceae;uncultured;
1	0	0	1	OSD32_6_14_NSI	Bacteria;Proteobacteria;Alphaproteobacteria;Rickettsiales;Rickettsiales Incertae Sedis;uncultured;
41	56	44	141	OSD32_6_14_NSI	Bacteria;Proteobacteria;Alphaproteobacteria;Rickettsiales;S25-593;
169	310	313	792	OSD32_6_14_NSI	Bacteria;Proteobacteria;Alphaproteobacteria;Rickettsiales;SAR116 clade;
9	7	4	20	OSD32_6_14_NSI	Bacteria;Proteobacteria;Alphaproteobacteria;Rickettsiales;SAR116 clade;Candidatus Puniceispirillum;
15	47	22	84	OSD32_6_14_NSI	Bacteria;Proteobacteria;Alphaproteobacteria;SAR11 clade;
5	2	0	7	OSD32_6_14_NSI	Bacteria;Proteobacteria;Alphaproteobacteria;SAR11 clade;Deep 1;
68	228	187	483	OSD32_6_14_NSI	Bacteria;Proteobacteria;Alphaproteobacteria;SAR11 clade;Surface 1;
1	1	0	2	OSD32_6_14_NSI	Bacteria;Proteobacteria;Alphaproteobacteria;SAR11 clade;Surface 1;Candidatus Pelagibacter;
14	43	84	141	OSD32_6_14_NSI	Bacteria;Proteobacteria;Alphaproteobacteria;SAR11 clade;Surface 2;
1	23	4	28	OSD32_6_14_NSI	Bacteria;Proteobacteria;Alphaproteobacteria;SAR11 clade;Surface 3;
43	83	110	236	OSD32_6_14_NSI	Bacteria;Proteobacteria;Alphaproteobacteria;SAR11 clade;Surface 4;
7	2	4	13	OSD32_6_14_NSI	Bacteria;Proteobacteria;Alphaproteobacteria;Sphingomonadales;Erythrobacteraceae;Erythrobacter;
2	3	3	8	OSD32_6_14_NSI	Bacteria;Proteobacteria;Alphaproteobacteria;Sphingomonadales;Erythrobacteraceae;Porphyrobacter;
1	1	0	2	OSD32_6_14_NSI	Bacteria;Proteobacteria;Alphaproteobacteria;Sphingomonadales;SD04E11;
1	1	1	3	OSD32_6_14_NSI	Bacteria;Proteobacteria;Alphaproteobacteria;Sphingomonadales;Sphingomonadaceae;Novosphingobium;
28	61	66	155	OSD32_6_14_NSI	Bacteria;Proteobacteria;Alphaproteobacteria;Sphingomonadales;Sphingomonadaceae;Sphingobium;
8	5	2	15	OSD32_6_14_NSI	Bacteria;Proteobacteria;Alphaproteobacteria;Sphingomonadales;Sphingomonadaceae;Sphingomonas;
3	2	0	5	OSD32_6_14_NSI	Bacteria;Proteobacteria;ARKICE-90;
5	4	3	12	OSD32_6_14_NSI	Bacteria;Proteobacteria;Betaproteobacteria;Burkholderiales;Alcaligenaceae;MWH-UniP1 aquatic group;
1	0	0	1	OSD32_6_14_NSI	Bacteria;Proteobacteria;Betaproteobacteria;Burkholderiales;Burkholderiaceae;Burkholderia-Paraburkholderia;
1	0	0	1	OSD32_6_14_NSI	Bacteria;Proteobacteria;Betaproteobacteria;Burkholderiales;Burkholderiaceae;Polynucleobacter;
1	0	0	1	OSD32_6_14_NSI	Bacteria;Proteobacteria;Betaproteobacteria;Burkholderiales;Oxalobacteraceae;Janthinobacterium;
4	2	1	7	OSD32_6_14_NSI	Bacteria;Proteobacteria;Betaproteobacteria;Hydrogenophilales;Hydrogenophilaceae;uncultured;
2	0	0	2	OSD32_6_14_NSI	Bacteria;Proteobacteria;Betaproteobacteria;Methylophilales;Methylophilaceae;OM43 clade;
1	0	0	1	OSD32_6_14_NSI	Bacteria;Proteobacteria;Betaproteobacteria;Neisseriales;Neisseriaceae;uncultured;
1	0	0	1	OSD32_6_14_NSI	Bacteria;Proteobacteria;Deltaproteobacteria;Bdellovibrionales;Bacteriovoracaceae;Halobacteriovorax;
3	0	0	3	OSD32_6_14_NSI	Bacteria;Proteobacteria;Deltaproteobacteria;Bdellovibrionales;Bacteriovoracaceae;Peredibacter;
2	5	6	13	OSD32_6_14_NSI	Bacteria;Proteobacteria;Deltaproteobacteria;Bdellovibrionales;Bacteriovoracaceae;uncultured;
21	3	6	30	OSD32_6_14_NSI	Bacteria;Proteobacteria;Deltaproteobacteria;Bdellovibrionales;Bdellovibrionaceae;OM27 clade;
10	1	0	11	OSD32_6_14_NSI	Bacteria;Proteobacteria;Deltaproteobacteria;Bradymonadales;
1	2	0	3	OSD32_6_14_NSI	Bacteria;Proteobacteria;Deltaproteobacteria;Desulfarculales;Desulfarculaceae;uncultured;
5	0	0	5	OSD32_6_14_NSI	Bacteria;Proteobacteria;Deltaproteobacteria;Myxococcales;BIrii41;
5	0	0	5	OSD32_6_14_NSI	Bacteria;Proteobacteria;Deltaproteobacteria;Myxococcales;Blfdi19;
1	0	0	1	OSD32_6_14_NSI	Bacteria;Proteobacteria;Deltaproteobacteria;Myxococcales;mle1-27;
2	1	1	4	OSD32_6_14_NSI	Bacteria;Proteobacteria;Deltaproteobacteria;Myxococcales;Nannocystaceae;uncultured;
5	2	6	13	OSD32_6_14_NSI	Bacteria;Proteobacteria;Deltaproteobacteria;Myxococcales;P3OB-42;
2	0	0	2	OSD32_6_14_NSI	Bacteria;Proteobacteria;Deltaproteobacteria;Myxococcales;Phaselicystidaceae;Phaselicystis;
1	2	0	3	OSD32_6_14_NSI	Bacteria;Proteobacteria;Deltaproteobacteria;NB1-j;
7	11	5	23	OSD32_6_14_NSI	Bacteria;Proteobacteria;Deltaproteobacteria;Oligoflexales;Oligoflexaceae;
3	1	0	4	OSD32_6_14_NSI	Bacteria;Proteobacteria;Deltaproteobacteria;Oligoflexales;Oligoflexaceae;Pseudobacteriovorax;
28	60	72	160	OSD32_6_14_NSI	Bacteria;Proteobacteria;Deltaproteobacteria;SAR324 clade(Marine group B);
1	0	0	1	OSD32_6_14_NSI	Bacteria;Proteobacteria;Epsilonproteobacteria;Campylobacterales;Campylobacteraceae;Arcobacter;
3	0	0	3	OSD32_6_14_NSI	Bacteria;Proteobacteria;Gammaproteobacteria;Aeromonadales;Aeromonadaceae;Aeromonas;
1	1	0	2	OSD32_6_14_NSI	Bacteria;Proteobacteria;Gammaproteobacteria;Alteromonadales;Alteromonadaceae;
6	17	20	43	OSD32_6_14_NSI	Bacteria;Proteobacteria;Gammaproteobacteria;Alteromonadales;Alteromonadaceae;Aestuariibacter;
3	2	0	5	OSD32_6_14_NSI	Bacteria;Proteobacteria;Gammaproteobacteria;Alteromonadales;Alteromonadaceae;Agaribacter;
3	1	0	4	OSD32_6_14_NSI	Bacteria;Proteobacteria;Gammaproteobacteria;Alteromonadales;Alteromonadaceae;Alteromonas;
2	0	0	2	OSD32_6_14_NSI	Bacteria;Proteobacteria;Gammaproteobacteria;Alteromonadales;Alteromonadaceae;Bowmanella;
2	0	0	2	OSD32_6_14_NSI	Bacteria;Proteobacteria;Gammaproteobacteria;Alteromonadales;Alteromonadaceae;Marinobacter;
5	9	4	18	OSD32_6_14_NSI	Bacteria;Proteobacteria;Gammaproteobacteria;Alteromonadales;Alteromonadaceae;Paraglaciecola;
9	6	5	20	OSD32_6_14_NSI	Bacteria;Proteobacteria;Gammaproteobacteria;Alteromonadales;Alteromonadaceae;uncultured;
3	3	5	11	OSD32_6_14_NSI	Bacteria;Proteobacteria;Gammaproteobacteria;Alteromonadales;Colwelliaceae;Colwellia;
6	3	2	11	OSD32_6_14_NSI	Bacteria;Proteobacteria;Gammaproteobacteria;Alteromonadales;Colwelliaceae;Thalassotalea;
12	11	3	26	OSD32_6_14_NSI	Bacteria;Proteobacteria;Gammaproteobacteria;Alteromonadales;Pseudoalteromonadaceae;Pseudoalteromonas;
1	1	0	2	OSD32_6_14_NSI	Bacteria;Proteobacteria;Gammaproteobacteria;Alteromonadales;Pseudoalteromonadaceae;Psychrosphaera;
3	2	4	9	OSD32_6_14_NSI	Bacteria;Proteobacteria;Gammaproteobacteria;Alteromonadales;Pseudoalteromonadaceae;uncultured;
3	1	0	4	OSD32_6_14_NSI	Bacteria;Proteobacteria;Gammaproteobacteria;Alteromonadales;Shewanellaceae;Shewanella;
2	3	1	6	OSD32_6_14_NSI	Bacteria;Proteobacteria;Gammaproteobacteria;Arenicellales;Arenicellaceae;Arenicella;
1	0	0	1	OSD32_6_14_NSI	Bacteria;Proteobacteria;Gammaproteobacteria;Cardiobacteriales;Cardiobacteriaceae;uncultured;
2	2	2	6	OSD32_6_14_NSI	Bacteria;Proteobacteria;Gammaproteobacteria;Cellvibrionales;Cellvibrionaceae;Maricurvus;
3	0	0	3	OSD32_6_14_NSI	Bacteria;Proteobacteria;Gammaproteobacteria;Cellvibrionales;Cellvibrionaceae;Simiduia;
1	0	0	1	OSD32_6_14_NSI	Bacteria;Proteobacteria;Gammaproteobacteria;Cellvibrionales;Cellvibrionaceae;Umboniibacter;
2	0	0	2	OSD32_6_14_NSI	Bacteria;Proteobacteria;Gammaproteobacteria;Cellvibrionales;Halieaceae;Halioglobus;
28	75	57	160	OSD32_6_14_NSI	Bacteria;Proteobacteria;Gammaproteobacteria;Cellvibrionales;Halieaceae;OM60(NOR5) clade;
3	3	1	7	OSD32_6_14_NSI	Bacteria;Proteobacteria;Gammaproteobacteria;Cellvibrionales;Halieaceae;Parahaliea;
1	0	0	1	OSD32_6_14_NSI	Bacteria;Proteobacteria;Gammaproteobacteria;Cellvibrionales;Halieaceae;Pseudohaliea;
1	0	0	1	OSD32_6_14_NSI	Bacteria;Proteobacteria;Gammaproteobacteria;Cellvibrionales;Porticoccaceae;C1-B045;
5	13	4	22	OSD32_6_14_NSI	Bacteria;Proteobacteria;Gammaproteobacteria;Cellvibrionales;Porticoccaceae;SAR92 clade;
7	8	6	21	OSD32_6_14_NSI	Bacteria;Proteobacteria;Gammaproteobacteria;Cellvibrionales;Spongiibacteraceae;BD1-7 clade;
1	0	0	1	OSD32_6_14_NSI	Bacteria;Proteobacteria;Gammaproteobacteria;Cellvibrionales;Spongiibacteraceae;Sinobacterium;
1	0	0	1	OSD32_6_14_NSI	Bacteria;Proteobacteria;Gammaproteobacteria;Cellvibrionales;Spongiibacteraceae;Spongiibacter;
1	0	0	1	OSD32_6_14_NSI	Bacteria;Proteobacteria;Gammaproteobacteria;CK-1C2-67;
1	1	2	4	OSD32_6_14_NSI	Bacteria;Proteobacteria;Gammaproteobacteria;E01-9C-26 marine group;
1	0	0	1	OSD32_6_14_NSI	Bacteria;Proteobacteria;Gammaproteobacteria;Enterobacteriales;Enterobacteriaceae;Buttiauxella;
40	44	5	89	OSD32_6_14_NSI	Bacteria;Proteobacteria;Gammaproteobacteria;Enterobacteriales;Enterobacteriaceae;Citrobacter;
1	0	0	1	OSD32_6_14_NSI	Bacteria;Proteobacteria;Gammaproteobacteria;Enterobacteriales;Enterobacteriaceae;Cronobacter;
23	83	202	308	OSD32_6_14_NSI	Bacteria;Proteobacteria;Gammaproteobacteria;Enterobacteriales;Enterobacteriaceae;Enterobacter;
12	8	0	20	OSD32_6_14_NSI	Bacteria;Proteobacteria;Gammaproteobacteria;Enterobacteriales;Enterobacteriaceae;Escherichia-Shigella;
5	3	0	8	OSD32_6_14_NSI	Bacteria;Proteobacteria;Gammaproteobacteria;Enterobacteriales;Enterobacteriaceae;Klebsiella;
1	0	0	1	OSD32_6_14_NSI	Bacteria;Proteobacteria;Gammaproteobacteria;Enterobacteriales;Enterobacteriaceae;Lelliottia;
1	0	0	1	OSD32_6_14_NSI	Bacteria;Proteobacteria;Gammaproteobacteria;Enterobacteriales;Enterobacteriaceae;Pantoea;
1	0	0	1	OSD32_6_14_NSI	Bacteria;Proteobacteria;Gammaproteobacteria;Enterobacteriales;Enterobacteriaceae;Pragia;
3	0	0	3	OSD32_6_14_NSI	Bacteria;Proteobacteria;Gammaproteobacteria;Enterobacteriales;Enterobacteriaceae;Rahnella;
7	9	2	18	OSD32_6_14_NSI	Bacteria;Proteobacteria;Gammaproteobacteria;Enterobacteriales;Enterobacteriaceae;Raoultella;
1	0	0	1	OSD32_6_14_NSI	Bacteria;Proteobacteria;Gammaproteobacteria;Enterobacteriales;Enterobacteriaceae;Rosenbergiella;
31	48	65	144	OSD32_6_14_NSI	Bacteria;Proteobacteria;Gammaproteobacteria;Enterobacteriales;Enterobacteriaceae;Serratia;
1	0	0	1	OSD32_6_14_NSI	Bacteria;Proteobacteria;Gammaproteobacteria;Enterobacteriales;Enterobacteriaceae;uncultured;
1	0	0	1	OSD32_6_14_NSI	Bacteria;Proteobacteria;Gammaproteobacteria;Enterobacteriales;Enterobacteriaceae;Yersinia;
1	1	0	2	OSD32_6_14_NSI	Bacteria;Proteobacteria;Gammaproteobacteria;Gammaproteobacteria Incertae Sedis;Unknown Family;Marinicella;
53	127	145	325	OSD32_6_14_NSI	Bacteria;Proteobacteria;Gammaproteobacteria;Gammaproteobacteria Incertae Sedis;Unknown Family;uncultured;
8	5	1	14	OSD32_6_14_NSI	Bacteria;Proteobacteria;Gammaproteobacteria;HTA4;
21	30	28	79	OSD32_6_14_NSI	Bacteria;Proteobacteria;Gammaproteobacteria;KI89A clade;
4	0	0	4	OSD32_6_14_NSI	Bacteria;Proteobacteria;Gammaproteobacteria;Legionellales;Coxiellaceae;Coxiella;
1	2	1	4	OSD32_6_14_NSI	Bacteria;Proteobacteria;Gammaproteobacteria;Methylococcales;Methylococcaceae;Methylovulum;
3	1	1	5	OSD32_6_14_NSI	Bacteria;Proteobacteria;Gammaproteobacteria;Oceanospirillales;
1	0	0	1	OSD32_6_14_NSI	Bacteria;Proteobacteria;Gammaproteobacteria;Oceanospirillales;Alcanivoracaceae;Alcanivorax;
3	3	1	7	OSD32_6_14_NSI	Bacteria;Proteobacteria;Gammaproteobacteria;Oceanospirillales;Alcanivoracaceae;Kangiella;
1	1	0	2	OSD32_6_14_NSI	Bacteria;Proteobacteria;Gammaproteobacteria;Oceanospirillales;CrystalBog021C3;
3	1	1	5	OSD32_6_14_NSI	Bacteria;Proteobacteria;Gammaproteobacteria;Oceanospirillales;Halomonadaceae;Halomonas;
1	0	0	1	OSD32_6_14_NSI	Bacteria;Proteobacteria;Gammaproteobacteria;Oceanospirillales;Halomonadaceae;Salinicola;
4	1	0	5	OSD32_6_14_NSI	Bacteria;Proteobacteria;Gammaproteobacteria;Oceanospirillales;JL-ETNP-Y6;
3	4	4	11	OSD32_6_14_NSI	Bacteria;Proteobacteria;Gammaproteobacteria;Oceanospirillales;Litoricolaceae;Litoricola;
4	6	0	10	OSD32_6_14_NSI	Bacteria;Proteobacteria;Gammaproteobacteria;Oceanospirillales;Oceanospirillaceae;Balneatrix;
12	3	0	15	OSD32_6_14_NSI	Bacteria;Proteobacteria;Gammaproteobacteria;Oceanospirillales;Oceanospirillaceae;Marinobacterium;
2	0	1	3	OSD32_6_14_NSI	Bacteria;Proteobacteria;Gammaproteobacteria;Oceanospirillales;Oceanospirillaceae;Marinomonas;
1	0	0	1	OSD32_6_14_NSI	Bacteria;Proteobacteria;Gammaproteobacteria;Oceanospirillales;Oceanospirillaceae;Oleibacter;
1	0	0	1	OSD32_6_14_NSI	Bacteria;Proteobacteria;Gammaproteobacteria;Oceanospirillales;Oceanospirillaceae;Oleispira;
20	26	41	87	OSD32_6_14_NSI	Bacteria;Proteobacteria;Gammaproteobacteria;Oceanospirillales;Oceanospirillaceae;Pseudohongiella;
1	0	0	1	OSD32_6_14_NSI	Bacteria;Proteobacteria;Gammaproteobacteria;Oceanospirillales;Oceanospirillaceae;uncultured;
8	8	4	20	OSD32_6_14_NSI	Bacteria;Proteobacteria;Gammaproteobacteria;Oceanospirillales;Oleiphilaceae;Oleiphilus;
18	15	14	47	OSD32_6_14_NSI	Bacteria;Proteobacteria;Gammaproteobacteria;Oceanospirillales;OM182 clade;
372	935	1269	2576	OSD32_6_14_NSI	Bacteria;Proteobacteria;Gammaproteobacteria;Oceanospirillales;SAR86 clade;
2	0	0	2	OSD32_6_14_NSI	Bacteria;Proteobacteria;Gammaproteobacteria;Pseudomonadales;Moraxellaceae;Acinetobacter;
7	4	1	12	OSD32_6_14_NSI	Bacteria;Proteobacteria;Gammaproteobacteria;Pseudomonadales;Pseudomonadaceae;Pseudomonas;
19	24	16	59	OSD32_6_14_NSI	Bacteria;Proteobacteria;Gammaproteobacteria;Salinisphaerales;Salinisphaeraceae;ZD0417 marine group;
1	0	0	1	OSD32_6_14_NSI	Bacteria;Proteobacteria;Gammaproteobacteria;Thiotrichales;Francisellaceae;Francisella;
5	2	6	13	OSD32_6_14_NSI	Bacteria;Proteobacteria;Gammaproteobacteria;Thiotrichales;Thiotrichaceae;Thiothrix;
5	0	0	5	OSD32_6_14_NSI	Bacteria;Proteobacteria;Gammaproteobacteria;Thiotrichales;Thiotrichales Incertae Sedis;Caedibacter;
3	0	0	3	OSD32_6_14_NSI	Bacteria;Proteobacteria;Gammaproteobacteria;Thiotrichales;uncultured;
2	2	2	6	OSD32_6_14_NSI	Bacteria;Proteobacteria;Gammaproteobacteria;Vibrionales;Vibrionaceae;Grimontia;
4	0	0	4	OSD32_6_14_NSI	Bacteria;Proteobacteria;Gammaproteobacteria;Vibrionales;Vibrionaceae;Photobacterium;
3	6	1	10	OSD32_6_14_NSI	Bacteria;Proteobacteria;Gammaproteobacteria;Vibrionales;Vibrionaceae;uncultured;
28	19	19	66	OSD32_6_14_NSI	Bacteria;Proteobacteria;Gammaproteobacteria;Vibrionales;Vibrionaceae;Vibrio;
9	7	4	20	OSD32_6_14_NSI	Bacteria;Proteobacteria;Gammaproteobacteria;Xanthomonadales;JTB255 marine benthic group;
1	0	0	1	OSD32_6_14_NSI	Bacteria;Proteobacteria;Gammaproteobacteria;Xanthomonadales;uncultured;
5	9	2	16	OSD32_6_14_NSI	Bacteria;Proteobacteria;Gammaproteobacteria;Xanthomonadales;Xanthomonadaceae;Stenotrophomonas;
2	0	0	2	OSD32_6_14_NSI	Bacteria;Proteobacteria;JdFBHP3;
3	2	3	8	OSD32_6_14_NSI	Bacteria;Proteobacteria;SPOTSOCT00m83;
5	9	8	22	OSD32_6_14_NSI	Bacteria;SBR1093;
3	3	7	13	OSD32_6_14_NSI	Bacteria;Verrucomicrobia;Arctic97B-4 marine group;
1	2	4	7	OSD32_6_14_NSI	Bacteria;Verrucomicrobia;OPB35 soil group;
1	0	0	1	OSD32_6_14_NSI	Bacteria;Verrucomicrobia;Opitutae;A714019;
1	0	0	1	OSD32_6_14_NSI	Bacteria;Verrucomicrobia;Opitutae;MB11C04 marine group;
7	2	2	11	OSD32_6_14_NSI	Bacteria;Verrucomicrobia;Opitutae;Puniceicoccales;Puniceicoccaceae;Coraliomargarita;
1	1	0	2	OSD32_6_14_NSI	Bacteria;Verrucomicrobia;Opitutae;Puniceicoccales;Puniceicoccaceae;Lentimonas;
2	0	0	2	OSD32_6_14_NSI	Bacteria;Verrucomicrobia;Opitutae;Puniceicoccales;Puniceicoccaceae;marine group;
1	0	0	1	OSD32_6_14_NSI	Bacteria;Verrucomicrobia;Opitutae;Puniceicoccales;Puniceicoccaceae;Pelagicoccus;
1	2	3	6	OSD32_6_14_NSI	Bacteria;Verrucomicrobia;Opitutae;Puniceicoccales;Puniceicoccaceae;uncultured;
12	16	21	49	OSD32_6_14_NSI	Bacteria;Verrucomicrobia;R76-B128;
4	1	4	9	OSD32_6_14_NSI	Bacteria;Verrucomicrobia;Verrucomicrobiae;Verrucomicrobiales;DEV007;
7	8	2	17	OSD32_6_14_NSI	Bacteria;Verrucomicrobia;Verrucomicrobiae;Verrucomicrobiales;Verrucomicrobiaceae;Persicirhabdus;
3	1	0	4	OSD32_6_14_NSI	Bacteria;Verrucomicrobia;Verrucomicrobiae;Verrucomicrobiales;Verrucomicrobiaceae;Roseibacillus;
184	244	357	785	OSD32_6_14_NSI	No Relative
2	5	0	7	OSD33_6_14_MI	Archaea;Bathyarchaeota;
2	0	0	2	OSD33_6_14_MI	Archaea;Euryarchaeota;Halobacteria;Halobacteriales;Halobacteriaceae;uncultured;
114	359	555	1028	OSD33_6_14_MI	Archaea;Euryarchaeota;Thermoplasmata;Thermoplasmatales;Marine Group II;
40	222	390	652	OSD33_6_14_MI	Archaea;Euryarchaeota;Thermoplasmata;Thermoplasmatales;Marine Group III;
1	0	0	1	OSD33_6_14_MI	Archaea;Thaumarchaeota;Marine Group I;
24	167	309	500	OSD33_6_14_MI	Archaea;Thaumarchaeota;Marine Group I;Unknown Order;Unknown Family;Candidatus Nitrosopelagicus;
47	294	615	956	OSD33_6_14_MI	Archaea;Thaumarchaeota;Marine Group I;Unknown Order;Unknown Family;Candidatus Nitrosopumilus;
2	2	7	11	OSD33_6_14_MI	Archaea;Woesearchaeota (DHVEG-6);
2	0	0	2	OSD33_6_14_MI	Bacteria;Acidobacteria;Holophagae;Subgroup 10;Sva0725;
1	0	0	1	OSD33_6_14_MI	Bacteria;Acidobacteria;Subgroup 6;
89	236	387	712	OSD33_6_14_MI	Bacteria;Actinobacteria;Acidimicrobiia;Acidimicrobiales;OM1 clade;Candidatus Actinomarina;
75	114	167	356	OSD33_6_14_MI	Bacteria;Actinobacteria;Acidimicrobiia;Acidimicrobiales;Sva0996 marine group;
1	0	0	1	OSD33_6_14_MI	Bacteria;Actinobacteria;Actinobacteria;PeM15;
1	0	0	1	OSD33_6_14_MI	Bacteria;Actinobacteria;Coriobacteriia;Coriobacteriales;Coriobacteriaceae;Olsenella;
1	0	0	1	OSD33_6_14_MI	Bacteria;Actinobacteria;Thermoleophilia;Solirubrobacterales;YNPFFP1;
1	0	0	1	OSD33_6_14_MI	Bacteria;Bacteroidetes;Bacteroidetes Incertae Sedis;Order III;Unknown Family;Balneola;
1	0	0	1	OSD33_6_14_MI	Bacteria;Bacteroidetes;Bacteroidia;Bacteroidales;Marinilabiaceae;uncultured;
1	0	0	1	OSD33_6_14_MI	Bacteria;Bacteroidetes;Cytophagia;Cytophagales;Cyclobacteriaceae;Cyclobacterium;
1	0	0	1	OSD33_6_14_MI	Bacteria;Bacteroidetes;Cytophagia;Cytophagales;Cytophagaceae;uncultured;
2	1	1	4	OSD33_6_14_MI	Bacteria;Bacteroidetes;Cytophagia;Cytophagales;Flammeovirgaceae;Fabibacter;
1	0	0	1	OSD33_6_14_MI	Bacteria;Bacteroidetes;Cytophagia;Cytophagales;Flammeovirgaceae;Flexithrix;
3	11	2	16	OSD33_6_14_MI	Bacteria;Bacteroidetes;Cytophagia;Cytophagales;Flammeovirgaceae;Marinoscillum;
1	2	6	9	OSD33_6_14_MI	Bacteria;Bacteroidetes;Cytophagia;Cytophagales;Flammeovirgaceae;Roseivirga;
5	1	0	6	OSD33_6_14_MI	Bacteria;Bacteroidetes;Cytophagia;Cytophagales;Flammeovirgaceae;uncultured;
3	0	0	3	OSD33_6_14_MI	Bacteria;Bacteroidetes;Flavobacteriia;Flavobacteriales;Cryomorphaceae;Crocinitomix;
5	3	0	8	OSD33_6_14_MI	Bacteria;Bacteroidetes;Flavobacteriia;Flavobacteriales;Cryomorphaceae;Fluviicola;
3	5	4	12	OSD33_6_14_MI	Bacteria;Bacteroidetes;Flavobacteriia;Flavobacteriales;Cryomorphaceae;NS10 marine group;
1	1	0	2	OSD33_6_14_MI	Bacteria;Bacteroidetes;Flavobacteriia;Flavobacteriales;Cryomorphaceae;Owenweeksia;
15	18	17	50	OSD33_6_14_MI	Bacteria;Bacteroidetes;Flavobacteriia;Flavobacteriales;Cryomorphaceae;uncultured;
1	0	0	1	OSD33_6_14_MI	Bacteria;Bacteroidetes;Flavobacteriia;Flavobacteriales;Flavobacteriaceae;Arenibacter;
1	0	0	1	OSD33_6_14_MI	Bacteria;Bacteroidetes;Flavobacteriia;Flavobacteriales;Flavobacteriaceae;Flavicella;
1	1	0	2	OSD33_6_14_MI	Bacteria;Bacteroidetes;Flavobacteriia;Flavobacteriales;Flavobacteriaceae;Formosa;
1	0	0	1	OSD33_6_14_MI	Bacteria;Bacteroidetes;Flavobacteriia;Flavobacteriales;Flavobacteriaceae;Jejudonia;
4	0	2	6	OSD33_6_14_MI	Bacteria;Bacteroidetes;Flavobacteriia;Flavobacteriales;Flavobacteriaceae;NS2b marine group;
25	55	55	135	OSD33_6_14_MI	Bacteria;Bacteroidetes;Flavobacteriia;Flavobacteriales;Flavobacteriaceae;NS4 marine group;
70	216	260	546	OSD33_6_14_MI	Bacteria;Bacteroidetes;Flavobacteriia;Flavobacteriales;Flavobacteriaceae;NS5 marine group;
1	2	4	7	OSD33_6_14_MI	Bacteria;Bacteroidetes;Flavobacteriia;Flavobacteriales;Flavobacteriaceae;Polaribacter 4;
2	1	0	3	OSD33_6_14_MI	Bacteria;Bacteroidetes;Flavobacteriia;Flavobacteriales;Flavobacteriaceae;Tenacibaculum;
1	0	0	1	OSD33_6_14_MI	Bacteria;Bacteroidetes;Flavobacteriia;Flavobacteriales;Flavobacteriaceae;Ulvibacter;
3	0	0	3	OSD33_6_14_MI	Bacteria;Bacteroidetes;Flavobacteriia;Flavobacteriales;Flavobacteriaceae;uncultured;
4	5	0	9	OSD33_6_14_MI	Bacteria;Bacteroidetes;Flavobacteriia;Flavobacteriales;NS7 marine group;
66	96	90	252	OSD33_6_14_MI	Bacteria;Bacteroidetes;Flavobacteriia;Flavobacteriales;NS9 marine group;
1	0	0	1	OSD33_6_14_MI	Bacteria;Bacteroidetes;Sphingobacteriia;Sphingobacteriales;Chitinophagaceae;uncultured;
1	1	0	2	OSD33_6_14_MI	Bacteria;Bacteroidetes;Sphingobacteriia;Sphingobacteriales;Lentimicrobiaceae;
2	0	0	2	OSD33_6_14_MI	Bacteria;Bacteroidetes;Sphingobacteriia;Sphingobacteriales;Saprospiraceae;Aureispira;
1	2	0	3	OSD33_6_14_MI	Bacteria;Bacteroidetes;Sphingobacteriia;Sphingobacteriales;Saprospiraceae;uncultured;
2	3	1	6	OSD33_6_14_MI	Bacteria;Chlamydiae;Chlamydiae;Chlamydiales;Parachlamydiaceae;Candidatus Mesochlamydia;
1	0	0	1	OSD33_6_14_MI	Bacteria;Chlamydiae;Chlamydiae;Chlamydiales;Simkaniaceae;Candidatus Fritschea;
1	0	0	1	OSD33_6_14_MI	Bacteria;Chlamydiae;Chlamydiae;Chlamydiales;Simkaniaceae;uncultured;
11	25	16	52	OSD33_6_14_MI	Bacteria;Chloroflexi;JG30-KF-CM66;
60	97	157	314	OSD33_6_14_MI	Bacteria;Chloroflexi;SAR202 clade;
285	469	597	1351	OSD33_6_14_MI	Bacteria;Cyanobacteria;Chloroplast;
51	76	68	195	OSD33_6_14_MI	Bacteria;Cyanobacteria;Cyanobacteria;SubsectionI;FamilyI;Prochlorococcus;
93	276	469	838	OSD33_6_14_MI	Bacteria;Cyanobacteria;Cyanobacteria;SubsectionI;FamilyI;Synechococcus;
1	0	0	1	OSD33_6_14_MI	Bacteria;Cyanobacteria;Cyanobacteria;SubsectionIII;FamilyI;Trichodesmium;
15	4	2	21	OSD33_6_14_MI	Bacteria;Cyanobacteria;ML635J-21;
23	55	63	141	OSD33_6_14_MI	Bacteria;Gemmatimonadetes;BD2-11 terrestrial group;
1	0	0	1	OSD33_6_14_MI	Bacteria;Hydrogenedentes;
215	407	475	1097	OSD33_6_14_MI	Bacteria;Marinimicrobia (SAR406 clade);
2	1	0	3	OSD33_6_14_MI	Bacteria;Nitrospinae;MD2898-B26;
2	1	0	3	OSD33_6_14_MI	Bacteria;Nitrospinae;Nitrospinia;Nitrospinales;Nitrospinaceae;Nitrospina;
16	19	27	62	OSD33_6_14_MI	Bacteria;Nitrospinae;Nitrospinia;Nitrospinales;Nitrospinaceae;uncultured;
2	0	0	2	OSD33_6_14_MI	Bacteria;Omnitrophica;Omnitrophica Incertae Sedis;Unknown Order;Unknown Family;Candidatus Omnitrophus;
1	0	0	1	OSD33_6_14_MI	Bacteria;Parcubacteria;
4	8	5	17	OSD33_6_14_MI	Bacteria;PAUC34f;
7	2	1	10	OSD33_6_14_MI	Bacteria;Planctomycetes;OM190;
7	0	0	7	OSD33_6_14_MI	Bacteria;Planctomycetes;Phycisphaerae;Phycisphaerales;Phycisphaeraceae;CL500-3;
8	4	0	12	OSD33_6_14_MI	Bacteria;Planctomycetes;Phycisphaerae;Phycisphaerales;Phycisphaeraceae;FS140-16B-02 marine group;
1	2	2	5	OSD33_6_14_MI	Bacteria;Planctomycetes;Phycisphaerae;Phycisphaerales;Phycisphaeraceae;JL-ETNP-F27;
1	0	0	1	OSD33_6_14_MI	Bacteria;Planctomycetes;Phycisphaerae;Phycisphaerales;Phycisphaeraceae;SM1A02;
2	1	0	3	OSD33_6_14_MI	Bacteria;Planctomycetes;Pla3 lineage;
1	0	0	1	OSD33_6_14_MI	Bacteria;Planctomycetes;Pla4 lineage;
4	1	1	6	OSD33_6_14_MI	Bacteria;Planctomycetes;Planctomycetacia;Planctomycetales;Planctomycetaceae;Planctomyces;
7	2	13	22	OSD33_6_14_MI	Bacteria;Planctomycetes;Planctomycetacia;Planctomycetales;Planctomycetaceae;Rhodopirellula;
1	0	0	1	OSD33_6_14_MI	Bacteria;Planctomycetes;Planctomycetacia;Planctomycetales;Planctomycetaceae;uncultured;
1	0	0	1	OSD33_6_14_MI	Bacteria;Poribacteria;
10	8	0	18	OSD33_6_14_MI	Bacteria;Proteobacteria;AEGEAN-245;
1	0	1	2	OSD33_6_14_MI	Bacteria;Proteobacteria;Alphaproteobacteria;4-Org1-14;
1	0	0	1	OSD33_6_14_MI	Bacteria;Proteobacteria;Alphaproteobacteria;Alphaproteobacteria Incertae Sedis;uncultured;
2	1	1	4	OSD33_6_14_MI	Bacteria;Proteobacteria;Alphaproteobacteria;Alphaproteobacteria Incertae Sedis;Unknown Family;uncultured;
1	0	0	1	OSD33_6_14_MI	Bacteria;Proteobacteria;Alphaproteobacteria;Caulobacterales;Caulobacteraceae;Phenylobacterium;
1	0	0	1	OSD33_6_14_MI	Bacteria;Proteobacteria;Alphaproteobacteria;Caulobacterales;Hyphomonadaceae;Glycocaulis;
3	1	0	4	OSD33_6_14_MI	Bacteria;Proteobacteria;Alphaproteobacteria;Caulobacterales;Hyphomonadaceae;Henriciella;
2	0	0	2	OSD33_6_14_MI	Bacteria;Proteobacteria;Alphaproteobacteria;Caulobacterales;Hyphomonadaceae;Hirschia;
2	1	3	6	OSD33_6_14_MI	Bacteria;Proteobacteria;Alphaproteobacteria;Caulobacterales;Hyphomonadaceae;Hyphomonas;
1	1	0	2	OSD33_6_14_MI	Bacteria;Proteobacteria;Alphaproteobacteria;Caulobacterales;Hyphomonadaceae;Litorimonas;
1	2	0	3	OSD33_6_14_MI	Bacteria;Proteobacteria;Alphaproteobacteria;Caulobacterales;Hyphomonadaceae;Oceanicaulis;
3	0	0	3	OSD33_6_14_MI	Bacteria;Proteobacteria;Alphaproteobacteria;Caulobacterales;Hyphomonadaceae;uncultured;
1	0	0	1	OSD33_6_14_MI	Bacteria;Proteobacteria;Alphaproteobacteria;Rhizobiales;Beijerinckiaceae;uncultured;
2	1	0	3	OSD33_6_14_MI	Bacteria;Proteobacteria;Alphaproteobacteria;Rhizobiales;Bradyrhizobiaceae;Bradyrhizobium;
1	0	0	1	OSD33_6_14_MI	Bacteria;Proteobacteria;Alphaproteobacteria;Rhizobiales;Hyphomicrobiaceae;Devosia;
1	0	3	4	OSD33_6_14_MI	Bacteria;Proteobacteria;Alphaproteobacteria;Rhizobiales;Hyphomicrobiaceae;Pelagibacterium;
16	26	39	81	OSD33_6_14_MI	Bacteria;Proteobacteria;Alphaproteobacteria;Rhizobiales;OCS116 clade;
2	0	0	2	OSD33_6_14_MI	Bacteria;Proteobacteria;Alphaproteobacteria;Rhizobiales;Phyllobacteriaceae;Mesorhizobium;
49	177	253	479	OSD33_6_14_MI	Bacteria;Proteobacteria;Alphaproteobacteria;Rhizobiales;PS1 clade;
1	0	0	1	OSD33_6_14_MI	Bacteria;Proteobacteria;Alphaproteobacteria;Rhizobiales;Rhodobiaceae;Anderseniella;
1	0	0	1	OSD33_6_14_MI	Bacteria;Proteobacteria;Alphaproteobacteria;Rhizobiales;Rhodobiaceae;uncultured;
1	0	0	1	OSD33_6_14_MI	Bacteria;Proteobacteria;Alphaproteobacteria;Rhizobiales;uncultured;
3	1	0	4	OSD33_6_14_MI	Bacteria;Proteobacteria;Alphaproteobacteria;Rhodobacterales;Rhodobacteraceae;Actibacterium;
4	3	1	8	OSD33_6_14_MI	Bacteria;Proteobacteria;Alphaproteobacteria;Rhodobacterales;Rhodobacteraceae;Albimonas;
1	0	0	1	OSD33_6_14_MI	Bacteria;Proteobacteria;Alphaproteobacteria;Rhodobacterales;Rhodobacteraceae;Amylibacter;
12	8	0	20	OSD33_6_14_MI	Bacteria;Proteobacteria;Alphaproteobacteria;Rhodobacterales;Rhodobacteraceae;Ascidiaceihabitans;
1	0	0	1	OSD33_6_14_MI	Bacteria;Proteobacteria;Alphaproteobacteria;Rhodobacterales;Rhodobacteraceae;Dinoroseobacter;
1	0	0	1	OSD33_6_14_MI	Bacteria;Proteobacteria;Alphaproteobacteria;Rhodobacterales;Rhodobacteraceae;Donghicola;
1	0	0	1	OSD33_6_14_MI	Bacteria;Proteobacteria;Alphaproteobacteria;Rhodobacterales;Rhodobacteraceae;Halocynthiibacter;
4	3	0	7	OSD33_6_14_MI	Bacteria;Proteobacteria;Alphaproteobacteria;Rhodobacterales;Rhodobacteraceae;Jannaschia;
1	0	0	1	OSD33_6_14_MI	Bacteria;Proteobacteria;Alphaproteobacteria;Rhodobacterales;Rhodobacteraceae;Labrenzia;
2	28	43	73	OSD33_6_14_MI	Bacteria;Proteobacteria;Alphaproteobacteria;Rhodobacterales;Rhodobacteraceae;Lentibacter;
1	0	0	1	OSD33_6_14_MI	Bacteria;Proteobacteria;Alphaproteobacteria;Rhodobacterales;Rhodobacteraceae;Litoreibacter;
1	0	0	1	OSD33_6_14_MI	Bacteria;Proteobacteria;Alphaproteobacteria;Rhodobacterales;Rhodobacteraceae;Lutimaribacter;
1	0	0	1	OSD33_6_14_MI	Bacteria;Proteobacteria;Alphaproteobacteria;Rhodobacterales;Rhodobacteraceae;Nereida;
3	0	0	3	OSD33_6_14_MI	Bacteria;Proteobacteria;Alphaproteobacteria;Rhodobacterales;Rhodobacteraceae;Oceanicola;
2	1	0	3	OSD33_6_14_MI	Bacteria;Proteobacteria;Alphaproteobacteria;Rhodobacterales;Rhodobacteraceae;Octadecabacter;
3	12	16	31	OSD33_6_14_MI	Bacteria;Proteobacteria;Alphaproteobacteria;Rhodobacterales;Rhodobacteraceae;Planktomarina;
1	0	0	1	OSD33_6_14_MI	Bacteria;Proteobacteria;Alphaproteobacteria;Rhodobacterales;Rhodobacteraceae;Pseudohalocynthiibacter;
1	0	0	1	OSD33_6_14_MI	Bacteria;Proteobacteria;Alphaproteobacteria;Rhodobacterales;Rhodobacteraceae;Pseudovibrio;
1	2	0	3	OSD33_6_14_MI	Bacteria;Proteobacteria;Alphaproteobacteria;Rhodobacterales;Rhodobacteraceae;Roseobacter clade NAC11-7 lineage;
1	1	0	2	OSD33_6_14_MI	Bacteria;Proteobacteria;Alphaproteobacteria;Rhodobacterales;Rhodobacteraceae;Roseobacter;
2	0	0	2	OSD33_6_14_MI	Bacteria;Proteobacteria;Alphaproteobacteria;Rhodobacterales;Rhodobacteraceae;Roseovarius;
1	0	0	1	OSD33_6_14_MI	Bacteria;Proteobacteria;Alphaproteobacteria;Rhodobacterales;Rhodobacteraceae;Sediminimonas;
2	1	0	3	OSD33_6_14_MI	Bacteria;Proteobacteria;Alphaproteobacteria;Rhodobacterales;Rhodobacteraceae;Sulfitobacter;
1	0	0	1	OSD33_6_14_MI	Bacteria;Proteobacteria;Alphaproteobacteria;Rhodobacterales;Rhodobacteraceae;Thalassobius;
1	0	0	1	OSD33_6_14_MI	Bacteria;Proteobacteria;Alphaproteobacteria;Rhodobacterales;Rhodobacteraceae;Tropicimonas;
101	149	157	407	OSD33_6_14_MI	Bacteria;Proteobacteria;Alphaproteobacteria;Rhodobacterales;Rhodobacteraceae;uncultured;
13	10	12	35	OSD33_6_14_MI	Bacteria;Proteobacteria;Alphaproteobacteria;Rhodospirillales;AT-s3-44;
133	280	355	768	OSD33_6_14_MI	Bacteria;Proteobacteria;Alphaproteobacteria;Rhodospirillales;Rhodospirillaceae;AEGEAN-169 marine group;
9	1	0	10	OSD33_6_14_MI	Bacteria;Proteobacteria;Alphaproteobacteria;Rhodospirillales;Rhodospirillaceae;Magnetospira;
1	0	0	1	OSD33_6_14_MI	Bacteria;Proteobacteria;Alphaproteobacteria;Rhodospirillales;Rhodospirillaceae;Nisaea;
76	89	130	295	OSD33_6_14_MI	Bacteria;Proteobacteria;Alphaproteobacteria;Rhodospirillales;Rhodospirillaceae;OM75 clade;
147	199	203	549	OSD33_6_14_MI	Bacteria;Proteobacteria;Alphaproteobacteria;Rhodospirillales;Rhodospirillaceae;uncultured;
2	1	1	4	OSD33_6_14_MI	Bacteria;Proteobacteria;Alphaproteobacteria;Rhodospirillales;Rhodospirillales Incertae Sedis;Reyranella;
1	1	1	3	OSD33_6_14_MI	Bacteria;Proteobacteria;Alphaproteobacteria;Rickettsiales;EF100-94H03;
2	1	0	3	OSD33_6_14_MI	Bacteria;Proteobacteria;Alphaproteobacteria;Rickettsiales;LWSR-14;
2	0	0	2	OSD33_6_14_MI	Bacteria;Proteobacteria;Alphaproteobacteria;Rickettsiales;MD3-55;
28	29	45	102	OSD33_6_14_MI	Bacteria;Proteobacteria;Alphaproteobacteria;Rickettsiales;Mitochondria;
1	0	0	1	OSD33_6_14_MI	Bacteria;Proteobacteria;Alphaproteobacteria;Rickettsiales;Rickettsiaceae;Orientia;
2	0	0	2	OSD33_6_14_MI	Bacteria;Proteobacteria;Alphaproteobacteria;Rickettsiales;Rickettsiaceae;uncultured;
19	20	36	75	OSD33_6_14_MI	Bacteria;Proteobacteria;Alphaproteobacteria;Rickettsiales;S25-593;
85	139	133	357	OSD33_6_14_MI	Bacteria;Proteobacteria;Alphaproteobacteria;Rickettsiales;SAR116 clade;
2	1	1	4	OSD33_6_14_MI	Bacteria;Proteobacteria;Alphaproteobacteria;Rickettsiales;SAR116 clade;Candidatus Puniceispirillum;
3	0	0	3	OSD33_6_14_MI	Bacteria;Proteobacteria;Alphaproteobacteria;Rickettsiales;SHWN-night2;
1	0	0	1	OSD33_6_14_MI	Bacteria;Proteobacteria;Alphaproteobacteria;Rickettsiales;SM2D12;
5	1	1	7	OSD33_6_14_MI	Bacteria;Proteobacteria;Alphaproteobacteria;Rickettsiales;T9d;
7	8	0	15	OSD33_6_14_MI	Bacteria;Proteobacteria;Alphaproteobacteria;SAR11 clade;
2	0	1	3	OSD33_6_14_MI	Bacteria;Proteobacteria;Alphaproteobacteria;SAR11 clade;Chesapeake-Delaware Bay;
9	4	0	13	OSD33_6_14_MI	Bacteria;Proteobacteria;Alphaproteobacteria;SAR11 clade;Deep 1;
45	119	113	277	OSD33_6_14_MI	Bacteria;Proteobacteria;Alphaproteobacteria;SAR11 clade;Surface 1;
4	30	27	61	OSD33_6_14_MI	Bacteria;Proteobacteria;Alphaproteobacteria;SAR11 clade;Surface 2;
69	88	114	271	OSD33_6_14_MI	Bacteria;Proteobacteria;Alphaproteobacteria;SAR11 clade;Surface 4;
1	0	0	1	OSD33_6_14_MI	Bacteria;Proteobacteria;Alphaproteobacteria;Sneathiellales;Sneathiellaceae;Sneathiella;
1	1	1	3	OSD33_6_14_MI	Bacteria;Proteobacteria;Alphaproteobacteria;Sphingomonadales;Erythrobacteraceae;Altererythrobacter;
1	0	0	1	OSD33_6_14_MI	Bacteria;Proteobacteria;Alphaproteobacteria;Sphingomonadales;Erythrobacteraceae;Croceicoccus;
10	3	1	14	OSD33_6_14_MI	Bacteria;Proteobacteria;Alphaproteobacteria;Sphingomonadales;Erythrobacteraceae;Erythrobacter;
1	0	0	1	OSD33_6_14_MI	Bacteria;Proteobacteria;Alphaproteobacteria;Sphingomonadales;Erythrobacteraceae;uncultured;
1	0	2	3	OSD33_6_14_MI	Bacteria;Proteobacteria;Alphaproteobacteria;Sphingomonadales;Sphingomonadaceae;Parasphingopyxis;
2	0	0	2	OSD33_6_14_MI	Bacteria;Proteobacteria;Alphaproteobacteria;Sphingomonadales;Sphingomonadaceae;Sphingobium;
3	3	2	8	OSD33_6_14_MI	Bacteria;Proteobacteria;ARKICE-90;
2	1	0	3	OSD33_6_14_MI	Bacteria;Proteobacteria;Betaproteobacteria;Burkholderiales;Alcaligenaceae;MWH-UniP1 aquatic group;
1	0	0	1	OSD33_6_14_MI	Bacteria;Proteobacteria;Betaproteobacteria;Burkholderiales;Burkholderiaceae;Limnobacter;
6	12	13	31	OSD33_6_14_MI	Bacteria;Proteobacteria;Betaproteobacteria;Burkholderiales;Burkholderiaceae;Ralstonia;
2	0	0	2	OSD33_6_14_MI	Bacteria;Proteobacteria;Betaproteobacteria;Burkholderiales;Comamonadaceae;Acidovorax;
1	0	0	1	OSD33_6_14_MI	Bacteria;Proteobacteria;Betaproteobacteria;Burkholderiales;Comamonadaceae;Aquabacterium;
1	0	0	1	OSD33_6_14_MI	Bacteria;Proteobacteria;Betaproteobacteria;Burkholderiales;Oxalobacteraceae;Janthinobacterium;
6	8	5	19	OSD33_6_14_MI	Bacteria;Proteobacteria;Betaproteobacteria;Hydrogenophilales;Hydrogenophilaceae;uncultured;
48	73	79	200	OSD33_6_14_MI	Bacteria;Proteobacteria;Betaproteobacteria;Methylophilales;Methylophilaceae;OM43 clade;
14	2	0	16	OSD33_6_14_MI	Bacteria;Proteobacteria;Deltaproteobacteria;Bdellovibrionales;Bdellovibrionaceae;OM27 clade;
7	0	1	8	OSD33_6_14_MI	Bacteria;Proteobacteria;Deltaproteobacteria;Bradymonadales;
1	0	0	1	OSD33_6_14_MI	Bacteria;Proteobacteria;Deltaproteobacteria;Desulfobacterales;Desulfobacteraceae;uncultured;
1	0	0	1	OSD33_6_14_MI	Bacteria;Proteobacteria;Deltaproteobacteria;Myxococcales;bacteriap25;
6	3	2	11	OSD33_6_14_MI	Bacteria;Proteobacteria;Deltaproteobacteria;Myxococcales;Blfdi19;
12	7	14	33	OSD33_6_14_MI	Bacteria;Proteobacteria;Deltaproteobacteria;Myxococcales;P3OB-42;
1	0	1	2	OSD33_6_14_MI	Bacteria;Proteobacteria;Deltaproteobacteria;Myxococcales;Sandaracinaceae;uncultured;
4	3	0	7	OSD33_6_14_MI	Bacteria;Proteobacteria;Deltaproteobacteria;NB1-j;
16	11	4	31	OSD33_6_14_MI	Bacteria;Proteobacteria;Deltaproteobacteria;Oligoflexales;Oligoflexaceae;
48	76	64	188	OSD33_6_14_MI	Bacteria;Proteobacteria;Deltaproteobacteria;SAR324 clade(Marine group B);
2	0	0	2	OSD33_6_14_MI	Bacteria;Proteobacteria;Epsilonproteobacteria;Campylobacterales;Helicobacteraceae;Sulfurovum;
2	3	1	6	OSD33_6_14_MI	Bacteria;Proteobacteria;Gammaproteobacteria;Alteromonadales;Alteromonadaceae;Alteromonas;
1	0	0	1	OSD33_6_14_MI	Bacteria;Proteobacteria;Gammaproteobacteria;Alteromonadales;Alteromonadaceae;Glaciecola;
3	1	1	5	OSD33_6_14_MI	Bacteria;Proteobacteria;Gammaproteobacteria;Alteromonadales;Alteromonadaceae;Marinobacter;
1	0	0	1	OSD33_6_14_MI	Bacteria;Proteobacteria;Gammaproteobacteria;Alteromonadales;Alteromonadaceae;Paraglaciecola;
2	3	0	5	OSD33_6_14_MI	Bacteria;Proteobacteria;Gammaproteobacteria;Alteromonadales;Colwelliaceae;Colwellia;
3	2	0	5	OSD33_6_14_MI	Bacteria;Proteobacteria;Gammaproteobacteria;Alteromonadales;Idiomarinaceae;Idiomarina;
3	3	0	6	OSD33_6_14_MI	Bacteria;Proteobacteria;Gammaproteobacteria;Alteromonadales;Pseudoalteromonadaceae;Pseudoalteromonas;
1	0	0	1	OSD33_6_14_MI	Bacteria;Proteobacteria;Gammaproteobacteria;Alteromonadales;Psychromonadaceae;Psychromonas;
1	0	0	1	OSD33_6_14_MI	Bacteria;Proteobacteria;Gammaproteobacteria;Alteromonadales;Shewanellaceae;Psychrobium;
3	6	4	13	OSD33_6_14_MI	Bacteria;Proteobacteria;Gammaproteobacteria;Alteromonadales;Shewanellaceae;Shewanella;
1	0	0	1	OSD33_6_14_MI	Bacteria;Proteobacteria;Gammaproteobacteria;Arenicellales;Arenicellaceae;uncultured;
1	0	0	1	OSD33_6_14_MI	Bacteria;Proteobacteria;Gammaproteobacteria;Cellvibrionales;BD2-7;
1	0	0	1	OSD33_6_14_MI	Bacteria;Proteobacteria;Gammaproteobacteria;Cellvibrionales;Cellvibrionaceae;Simiduia;
1	0	0	1	OSD33_6_14_MI	Bacteria;Proteobacteria;Gammaproteobacteria;Cellvibrionales;Halieaceae;Haliea;
2	0	0	2	OSD33_6_14_MI	Bacteria;Proteobacteria;Gammaproteobacteria;Cellvibrionales;Halieaceae;Luminiphilus;
15	14	4	33	OSD33_6_14_MI	Bacteria;Proteobacteria;Gammaproteobacteria;Cellvibrionales;Halieaceae;OM60(NOR5) clade;
3	4	5	12	OSD33_6_14_MI	Bacteria;Proteobacteria;Gammaproteobacteria;Cellvibrionales;Halieaceae;Parahaliea;
1	1	0	2	OSD33_6_14_MI	Bacteria;Proteobacteria;Gammaproteobacteria;Cellvibrionales;Porticoccaceae;C1-B045;
4	7	0	11	OSD33_6_14_MI	Bacteria;Proteobacteria;Gammaproteobacteria;Cellvibrionales;Porticoccaceae;SAR92 clade;
4	0	0	4	OSD33_6_14_MI	Bacteria;Proteobacteria;Gammaproteobacteria;Cellvibrionales;Spongiibacteraceae;BD1-7 clade;
2	2	1	5	OSD33_6_14_MI	Bacteria;Proteobacteria;Gammaproteobacteria;Cellvibrionales;Spongiibacteraceae;Dasania;
2	0	0	2	OSD33_6_14_MI	Bacteria;Proteobacteria;Gammaproteobacteria;Cellvibrionales;Spongiibacteraceae;Oceanicoccus;
1	0	0	1	OSD33_6_14_MI	Bacteria;Proteobacteria;Gammaproteobacteria;Cellvibrionales;Spongiibacteraceae;Spongiibacter;
1	2	1	4	OSD33_6_14_MI	Bacteria;Proteobacteria;Gammaproteobacteria;Cellvibrionales;Spongiibacteraceae;Zhongshania;
2	0	0	2	OSD33_6_14_MI	Bacteria;Proteobacteria;Gammaproteobacteria;Chromatiales;Granulosicoccaceae;Granulosicoccus;
26	32	35	93	OSD33_6_14_MI	Bacteria;Proteobacteria;Gammaproteobacteria;E01-9C-26 marine group;
6	4	36	46	OSD33_6_14_MI	Bacteria;Proteobacteria;Gammaproteobacteria;Enterobacteriales;Enterobacteriaceae;Citrobacter;
7	25	1	33	OSD33_6_14_MI	Bacteria;Proteobacteria;Gammaproteobacteria;Enterobacteriales;Enterobacteriaceae;Enterobacter;
2	0	0	2	OSD33_6_14_MI	Bacteria;Proteobacteria;Gammaproteobacteria;Enterobacteriales;Enterobacteriaceae;Escherichia-Shigella;
1	2	0	3	OSD33_6_14_MI	Bacteria;Proteobacteria;Gammaproteobacteria;Enterobacteriales;Enterobacteriaceae;Klebsiella;
2	0	0	2	OSD33_6_14_MI	Bacteria;Proteobacteria;Gammaproteobacteria;Enterobacteriales;Enterobacteriaceae;Rahnella;
1	0	0	1	OSD33_6_14_MI	Bacteria;Proteobacteria;Gammaproteobacteria;Enterobacteriales;Enterobacteriaceae;Raoultella;
5	10	11	26	OSD33_6_14_MI	Bacteria;Proteobacteria;Gammaproteobacteria;Enterobacteriales;Enterobacteriaceae;Serratia;
1	0	0	1	OSD33_6_14_MI	Bacteria;Proteobacteria;Gammaproteobacteria;Enterobacteriales;Enterobacteriaceae;Yersinia;
2	0	0	2	OSD33_6_14_MI	Bacteria;Proteobacteria;Gammaproteobacteria;Gammaproteobacteria Incertae Sedis;Unknown Family;Marinicella;
1	0	0	1	OSD33_6_14_MI	Bacteria;Proteobacteria;Gammaproteobacteria;Gammaproteobacteria Incertae Sedis;Unknown Family;Thiohalophilus;
28	38	75	141	OSD33_6_14_MI	Bacteria;Proteobacteria;Gammaproteobacteria;Gammaproteobacteria Incertae Sedis;Unknown Family;uncultured;
3	0	0	3	OSD33_6_14_MI	Bacteria;Proteobacteria;Gammaproteobacteria;HTA4;
18	22	27	67	OSD33_6_14_MI	Bacteria;Proteobacteria;Gammaproteobacteria;KI89A clade;
11	4	1	16	OSD33_6_14_MI	Bacteria;Proteobacteria;Gammaproteobacteria;Legionellales;Coxiellaceae;Coxiella;
1	1	0	2	OSD33_6_14_MI	Bacteria;Proteobacteria;Gammaproteobacteria;Legionellales;Legionellaceae;uncultured;
8	2	1	11	OSD33_6_14_MI	Bacteria;Proteobacteria;Gammaproteobacteria;Oceanospirillales;Alcanivoracaceae;Alcanivorax;
1	0	0	1	OSD33_6_14_MI	Bacteria;Proteobacteria;Gammaproteobacteria;Oceanospirillales;Alcanivoracaceae;Kangiella;
1	0	0	1	OSD33_6_14_MI	Bacteria;Proteobacteria;Gammaproteobacteria;Oceanospirillales;Hahellaceae;Endozoicomonas;
2	0	0	2	OSD33_6_14_MI	Bacteria;Proteobacteria;Gammaproteobacteria;Oceanospirillales;Halomonadaceae;Halomonas;
1	0	0	1	OSD33_6_14_MI	Bacteria;Proteobacteria;Gammaproteobacteria;Oceanospirillales;Halomonadaceae;Salinicola;
12	38	6	56	OSD33_6_14_MI	Bacteria;Proteobacteria;Gammaproteobacteria;Oceanospirillales;J8P41000-1F04;
13	3	0	16	OSD33_6_14_MI	Bacteria;Proteobacteria;Gammaproteobacteria;Oceanospirillales;JL-ETNP-Y6;
1	0	0	1	OSD33_6_14_MI	Bacteria;Proteobacteria;Gammaproteobacteria;Oceanospirillales;Litoricolaceae;Litoricola;
1	0	0	1	OSD33_6_14_MI	Bacteria;Proteobacteria;Gammaproteobacteria;Oceanospirillales;Nit5Au0613-695;
3	0	0	3	OSD33_6_14_MI	Bacteria;Proteobacteria;Gammaproteobacteria;Oceanospirillales;Oceanospirillaceae;Balneatrix;
3	0	0	3	OSD33_6_14_MI	Bacteria;Proteobacteria;Gammaproteobacteria;Oceanospirillales;Oceanospirillaceae;Marinobacterium;
1	0	0	1	OSD33_6_14_MI	Bacteria;Proteobacteria;Gammaproteobacteria;Oceanospirillales;Oceanospirillaceae;Neptuniibacter;
1	0	0	1	OSD33_6_14_MI	Bacteria;Proteobacteria;Gammaproteobacteria;Oceanospirillales;Oceanospirillaceae;Oceanobacter;
1	0	0	1	OSD33_6_14_MI	Bacteria;Proteobacteria;Gammaproteobacteria;Oceanospirillales;Oceanospirillaceae;Oleispira;
39	84	115	238	OSD33_6_14_MI	Bacteria;Proteobacteria;Gammaproteobacteria;Oceanospirillales;Oceanospirillaceae;Pseudohongiella;
1	0	0	1	OSD33_6_14_MI	Bacteria;Proteobacteria;Gammaproteobacteria;Oceanospirillales;Oceanospirillaceae;uncultured;
1	0	0	1	OSD33_6_14_MI	Bacteria;Proteobacteria;Gammaproteobacteria;Oceanospirillales;Oleiphilaceae;Oleiphilus;
13	21	7	41	OSD33_6_14_MI	Bacteria;Proteobacteria;Gammaproteobacteria;Oceanospirillales;OM182 clade;
151	317	390	858	OSD33_6_14_MI	Bacteria;Proteobacteria;Gammaproteobacteria;Oceanospirillales;SAR86 clade;
1	0	0	1	OSD33_6_14_MI	Bacteria;Proteobacteria;Gammaproteobacteria;Oceanospirillales;SS1-B-06-26;
6	0	0	6	OSD33_6_14_MI	Bacteria;Proteobacteria;Gammaproteobacteria;Oceanospirillales;SUP05 cluster;
32	44	99	175	OSD33_6_14_MI	Bacteria;Proteobacteria;Gammaproteobacteria;Oceanospirillales;ZD0405;
3	2	0	5	OSD33_6_14_MI	Bacteria;Proteobacteria;Gammaproteobacteria;Pseudomonadales;Moraxellaceae;Acinetobacter;
1	0	1	2	OSD33_6_14_MI	Bacteria;Proteobacteria;Gammaproteobacteria;Pseudomonadales;Moraxellaceae;Perlucidibaca;
2	0	0	2	OSD33_6_14_MI	Bacteria;Proteobacteria;Gammaproteobacteria;Pseudomonadales;Moraxellaceae;Psychrobacter;
5	4	4	13	OSD33_6_14_MI	Bacteria;Proteobacteria;Gammaproteobacteria;Pseudomonadales;Pseudomonadaceae;Pseudomonas;
1	0	0	1	OSD33_6_14_MI	Bacteria;Proteobacteria;Gammaproteobacteria;PYR10d3;
8	11	11	30	OSD33_6_14_MI	Bacteria;Proteobacteria;Gammaproteobacteria;Salinisphaerales;Salinisphaeraceae;Oceanococcus;
1	0	0	1	OSD33_6_14_MI	Bacteria;Proteobacteria;Gammaproteobacteria;Salinisphaerales;Salinisphaeraceae;Salinisphaera;
47	76	94	217	OSD33_6_14_MI	Bacteria;Proteobacteria;Gammaproteobacteria;Salinisphaerales;Salinisphaeraceae;ZD0417 marine group;
1	0	0	1	OSD33_6_14_MI	Bacteria;Proteobacteria;Gammaproteobacteria;Thiotrichales;Francisellaceae;Francisella;
1	0	0	1	OSD33_6_14_MI	Bacteria;Proteobacteria;Gammaproteobacteria;Thiotrichales;Gven-D09;
2	4	2	8	OSD33_6_14_MI	Bacteria;Proteobacteria;Gammaproteobacteria;Thiotrichales;Piscirickettsiaceae;Cycloclasticus;
1	1	0	2	OSD33_6_14_MI	Bacteria;Proteobacteria;Gammaproteobacteria;Thiotrichales;Piscirickettsiaceae;Methylophaga;
3	9	7	19	OSD33_6_14_MI	Bacteria;Proteobacteria;Gammaproteobacteria;Thiotrichales;Thiotrichaceae;Thiothrix;
1	0	0	1	OSD33_6_14_MI	Bacteria;Proteobacteria;Gammaproteobacteria;Thiotrichales;Thiotrichales Incertae Sedis;Caedibacter;
6	5	2	13	OSD33_6_14_MI	Bacteria;Proteobacteria;Gammaproteobacteria;Thiotrichales;Thiotrichales Incertae Sedis;Candidatus Endoecteinascidia;
1	0	0	1	OSD33_6_14_MI	Bacteria;Proteobacteria;Gammaproteobacteria;Thiotrichales;uncultured;
6	6	2	14	OSD33_6_14_MI	Bacteria;Proteobacteria;Gammaproteobacteria;uncultured;
2	2	0	4	OSD33_6_14_MI	Bacteria;Proteobacteria;Gammaproteobacteria;Vibrionales;Vibrionaceae;Photobacterium;
1	0	0	1	OSD33_6_14_MI	Bacteria;Proteobacteria;Gammaproteobacteria;Vibrionales;Vibrionaceae;Vibrio;
1	0	0	1	OSD33_6_14_MI	Bacteria;Proteobacteria;Gammaproteobacteria;Xanthomonadales;Algiphilaceae;Algiphilus;
18	16	18	52	OSD33_6_14_MI	Bacteria;Proteobacteria;Gammaproteobacteria;Xanthomonadales;JTB255 marine benthic group;
1	1	0	2	OSD33_6_14_MI	Bacteria;Proteobacteria;Gammaproteobacteria;Xanthomonadales;Solimonadaceae;Polycyclovorans;
8	17	17	42	OSD33_6_14_MI	Bacteria;Proteobacteria;Gammaproteobacteria;Xanthomonadales;uncultured;
1	0	0	1	OSD33_6_14_MI	Bacteria;Proteobacteria;Gammaproteobacteria;Xanthomonadales;Xanthomonadaceae;Stenotrophomonas;
5	2	0	7	OSD33_6_14_MI	Bacteria;Proteobacteria;JdFBHP3;
1	0	0	1	OSD33_6_14_MI	Bacteria;Proteobacteria;JTB23;
1	0	0	1	OSD33_6_14_MI	Bacteria;Proteobacteria;Skagenf62;
13	25	17	55	OSD33_6_14_MI	Bacteria;Proteobacteria;SPOTSOCT00m83;
17	50	78	145	OSD33_6_14_MI	Bacteria;SBR1093;
1	0	0	1	OSD33_6_14_MI	Bacteria;TM6 (Dependentiae);
6	6	2	14	OSD33_6_14_MI	Bacteria;Verrucomicrobia;Arctic97B-4 marine group;
6	8	10	24	OSD33_6_14_MI	Bacteria;Verrucomicrobia;OPB35 soil group;
1	0	0	1	OSD33_6_14_MI	Bacteria;Verrucomicrobia;Opitutae;A714019;
4	4	0	8	OSD33_6_14_MI	Bacteria;Verrucomicrobia;Opitutae;MB11C04 marine group;
1	0	0	1	OSD33_6_14_MI	Bacteria;Verrucomicrobia;Opitutae;Puniceicoccales;Puniceicoccaceae;Cerasicoccus;
2	2	2	6	OSD33_6_14_MI	Bacteria;Verrucomicrobia;Opitutae;Puniceicoccales;Puniceicoccaceae;marine group;
1	0	0	1	OSD33_6_14_MI	Bacteria;Verrucomicrobia;Opitutae;Puniceicoccales;Puniceicoccaceae;Pelagicoccus;
8	4	4	16	OSD33_6_14_MI	Bacteria;Verrucomicrobia;Verrucomicrobiae;Verrucomicrobiales;DEV007;
1	0	0	1	OSD33_6_14_MI	Bacteria;Verrucomicrobia;Verrucomicrobiae;Verrucomicrobiales;Rubritaleaceae;Rubritalea;
2	1	4	7	OSD33_6_14_MI	Bacteria;Verrucomicrobia;Verrucomicrobiae;Verrucomicrobiales;Verrucomicrobiaceae;Roseibacillus;
83	197	323	603	OSD33_6_14_MI	No Relative
